Fold: Gập lại
Reserve: Dự trữ
Rescue: Cứu hộ
Twenty: Hai mươi
Rat: Con chuột
Rational: Hợp lý
Envision: Hình dung
Memory: Ký ức
Folk: Dân gian
Raw: Thô
Gender: Giới tính
Chick: Chick
Freedom: Sự tự do
Hurt: Đau
Decent: Phong nha
Sphere: Quả cầu
Western: Miền tây
Grow: Lớn lên
Gang: Băng nhóm
Sure: Chắc chắn rồi
Massive: To lớn
Eventually: Cuối cùng
Approval: Sự chấp thuận
Distinction: Phân biệt
Weekend: Ngày cuối tuần
Arrow: Mũi tên
Small: Nhỏ bé
Employer: Nhà tuyển dụng
Wilderness: Hoang dã
Promise: Lời hứa
Supposed: Giả định
Employee: Nhân viên
Game: Trò chơi
Diet: Chế độ ăn
Legitimate: Hợp pháp
Totally: Hoàn toàn
Balanced: Cân bằng
A: Một
Selection: Lựa chọn
Widespread: Phổ biến rộng rãi
I: Tôi
Affair: Chuyện
Protest: Phản đối
Reasonable: Hợp lý
Food: Món ăn
Lightly: Nhẹ nhàng
Center: Trung tâm
Happiness: Hạnh phúc
Oxygen: Ôxy
Artistic: Nghệ thuật
Effectiveness: Hiệu quả
Precisely: Đúng
Reminder: Nhắc nhở
Independence: Độc lập
Nobody: Không ai
Intent: Ý định
Rank: Cấp
Presentation: Trình bày
Subsidy: Trợ cấp
Exciting: Thú vị
Marry: Kết hôn
Red: Đỏ
Agreement: Thỏa thuận
Act: Hành động
Cover: Che
Weaken: Làm suy yếu
Length: Chiều dài
Exclusively: Duy nhất
Undergo: Trải qua
Intend: Dự định
Patrol: Tuần tra
Patron: Người bảo trợ
Add: Thêm vào
Comparable: So sánh
Excited: Bị kích thích
Cooking: Nấu nướng
Again: Lần nữa
Its: Của nó
Careful: Cẩn thận
Desperate: Tuyệt vọng
Glance: Nháy mắt
Light: Ánh sáng
Multiply: Nhân
Candidate: Ứng viên
Rape: Hãm hiếp
Experimental: Thử nghiệm
Personally: Cá nhân
Whom: Ai
Fool: Ngu xuẩn
Foot: Chân
Obtain: Đạt được
Focus: Tiêu điểm
Video: Video
Unique: Độc nhất
Complicated: Phức tạp
Fork: Cái nĩa
Form: Hình thức
Shooting: Chụp
Enroll: Ghi danh
Fiber: Chất xơ
Gate: Cánh cổng
Surely: Chắc chắn
Rocket: Tên lửa
Limited: Giới hạn
Employment: Việc làm
Hardware: Phần cứng
Present: Hiện tại
Kept: Giữ
Age: Tuổi tác
Composition: Thành phần
Young: Trẻ
Multiple: Nhiều
Borrow: Vay
Rare: Hiếm
Ago: Trước
Rib: Xương sườn
Fatal: Gây tử vong
Motivate: Động viên
Rid: Thoát khỏi
Initiative: Sáng kiến
Arrangement: Sắp xếp
Romantic: Lãng mạn
Nominee: Ứng cử viên
Rim: Rim
Rip: Yên nghỉ
Ultimately: Cuối cùng
Popular: Phổ biến
Gave: Đưa ra
Instruction: Chỉ dẫn
Sword: Thanh kiếm
Africanamerican: Người mỹ gốc phi
Ribbon: Ribbon
Vowel: Nguyên âm
Verb: Động từ
Conviction: Lòng tin chắc, sự kết án, phán quyết
Available: Có sẵn
Aid: Viện trợ
Encourage: Khuyến khích
Overnight: Qua đêm
Universal: Phổ cập
Aim: Mục đích
Rate: Tỷ lệ
Plot: Âm mưu
Air: Không khí
Verbal: Lời nói
Bucket: Cái xô
Articulate: Khớp nối
Undermine: Phá hoại
Wheelchair: Xe lăn
Actual: Thực tế
Rehabilitation: Phục hồi chức năng
Transport: Vận chuyển
Bishop: Giám mục
Knee: Đầu gối
Warning: Cảnh báo
Arise: Nảy sinh
Corruption: Tham nhũng
Porch: Hiên nhà
Draw: Vẽ tranh
Evening: Tối
Counselor: Cố vấn
Presidency: Chức tổng thống
Agree: Đồng ý
Supply: Cung cấp
Citizen: Công dân
Academic: Học tập
Oral: Miệng
Troop (pl): Quân (pl)
Slope: Dốc
Prevention: Phòng ngừa
Prominent: Nổi bật
Knew: Biết
Nonetheless: Dù sao
Four: Bốn
Neighbor: Hàng xóm
Rhythm: Nhịp
Touchdown: Đụng
Manage: Quản lý
Outline: Đề cương
Layer: Lớp
Smart: Thông minh
Syndrome: Hội chứng
Drag: Kéo
Else: Khác
Theme: Chủ đề
Buddy: Bạn bè
Very: Rất
Straight: Thẳng
All: Tất cả các
Gaze: Nhìn chằm chằm
Thousand: Nghìn
Dirt: Bẩn
Proper: Phù hợp
Merely: Đơn thuần
Generous: Hào phóng
Random: Ngẫu nhiên
Disc: Đĩa
Education: Giáo dục
Coal: Than
Dish: Món ăn
Plus: Thêm
Disk: Đĩa
Shrimp: Con tôm
Coat: Áo khoác
Conclusion: Phần kết luận
Exotic: Kỳ lạ
Rod: Gậy
Lonely: Cô đơn
Brought: Đưa
Wagon: Toa xe
Ceremony: Lễ
Embarrassed: Xấu hổ
Trouble: Rắc rối
Hearing: Thính giác
Discrimination: Kỳ thị
Consequently: Hậu quả là
And: Và
Shrink: Co lại
Death: Tử vong
Row: Hàng
Intervention: Can thiệp
Stadium: Sân vận động
Bench: Băng ghế
Hurry: Vội
Exclude: Loại trừ
Absorb: Hấp thụ
Sibling: Anh chị em ruột
Influential: Có ảnh hưởng
Any: Bất kì
Studio: Studio
Companion: Đồng hành
Function: Chức năng
Magnetic: Từ tính
Historian: Nhà sử học
Publish: Công bố
Twice: Hai lần
That: Cái đó
Than: Hơn
Their: Họ
Point: Điểm
Array: Mảng
Fellow: Đồng bào
Major: Chính
Collaboration: Hợp tác
Costume: Trang phục
Isolation: Cô lập
Jar: Lọ
Traveler: Du khách
Incident: Biến cố
Investor: Nhà đầu tư
Edge: Cạnh
Regret: Hối tiếc
App: Mẫu vật
Jaw: Hàm
Seat: Ghế
Suspect: Nghi ngờ
Curious: Hiếu kỳ
Entertainment: Sự giải trí
Edit: Chỉnh sửa
Blast: Vụ nổ
Document: Tài liệu
Suite: Suite
Matter: Vấn đề
Then: Sau đó
Legislator: Nhà lập pháp
Them: Họ
Productivity: Năng suất
Negotiation: Đàm phán
Head: Cái đầu
Village: Làng
Refrigerator: Tủ lạnh
Heal: Chữa lành
Hear: Nghe
Code: Mã
Offering: Chào bán
Scenario: Kịch bản
Sneak: Sneak
Heat: Nhiệt
Sexual: Tình dục
Are: Là
Influence: Ảnh hưởng
Gross: Tổng
Seal: Niêm phong
Arm: Cánh tay
Toward: Đối với
Stock: Cổ phần
Ridge: Cây rơm
Punishment: Hình phạt
Group: Nhóm
Art: Nghệ thuật
Highlight: Điểm nổi bật
Pull: Kéo
Continuous: Liên tiếp
Leather: Da
Ruling: Phán quyết
Texture: Kết cấu
Union: Liên hiệp
Administrative: Hành chính
Ash: Tro
Domestic: Trong nước
Ask: Hỏi
Reveal: Tiết lộ
Rub: Chà xát
Ass: Mông
Foreign: Ngoại quốc
Nature: Thiên nhiên
Against: Chống lại
Motion: Chuyển động
Ticket: Vé
Novel: Cuốn tiểu thuyết
Chocolate: Sô cô la
Run: Chạy
Declare: Khai
Normal: Bình thường
They: Họ
Jet: Máy bay phản lực
Jew: Người do thái
Frustration: Thất vọng
Tongue: Lưỡi
Reinforce: Củng cố
Morning: Buổi sáng
Know: Biết
Alcohol: Rượu
Derive: Lấy được
Scientific: Thuộc về khoa học
Hypothesis: Giả thuyết
Court: Tòa án
Coin: Đồng tiền
Amendment: Sửa đổi
Contractor: Nhà thầu
There: Ở đó
Cattle: Gia súc
Dinner: Bữa tối
Search: Tìm kiếm
This: Điều này
Unlike: Không giống
Thin: Gầy
Ultimate: Tối hậu
Creation: Sự sáng tạo
Heel: Gót chân
Attention: Chú ý
Involved: Có tính liên quan
Fucking: Fucking
Judicial: Tư pháp
Pump: Máy bơm
These: Những
Seed: Giống
College: Trường đại học
Region: Khu vực
District: Huyện
Seem: Hình như
Seek: Tìm kiếm
Italian: Người ý
Collect: Sưu tầm
Aids: Aids
Fifteen: Mười lăm
Traditionally: Theo truyền thống
Dignity: Phẩm giá
Mountain: Núi
Aide: Trợ lý
Wide: Rộng
Blame: Khiển trách
Damn: Chỉ trích
Evident: Hiển nhiên
Supporter: Người ủng hộ
Blank: Chỗ trống
Others: Khác
Purchase: Mua, tựa vào, bám vào
Happy: Vui mừng
Intense: Cường độ cao
Agricultural: Nông nghiệp
Purpose: Mục đích
Boring: Nhàm chán
Rider: Người lái
Paragraph: Đoạn văn
Provider: Các nhà cung cấp
Partly: Từng phần
Suitable: Thích hợp
Recommend: Giới thiệu
Potentially: Có khả năng
Neighboring: Lân cận
Fortune: Vận may
Provided: Cung cấp
Disturb: Xáo trộn
Lecture: Bài học
Come: Đến
Support: Ủng hộ
Important: Quan trọng
Balloon: Quả bóng bay
Disaster: Thảm họa
Count: Đếm
Furniture: Đồ nội thất
Conference: Hội nghị
Lift: Thang máy
Importance: Tầm quan trọng
Training: Đào tạo
Improvement: Cải tiến
Suppose: Giả sử
Aggressive: Xâm lược
Network: Mạng
Computer: Máy vi tính
Wife: Người vợ
Poetry: Thơ phú
Push: Đẩy
Sensation: Cảm giác
Cold: Lạnh
Degree: Trình độ
Headquarters: Trụ sở chính
Frozen: Đông lạnh
Lawsuit: Kiện tụng
Drop: Rơi vãi
Flying: Bay
Nonprofit: Phi lợi nhuận
Beginning: Bắt đầu
Finding: Phát hiện
Athletic: Khỏe mạnh
Life: Đời sống
Perception: Nhận thức
Object: Vật
Pure: Nguyên chất
Thirty: Ba mươi
Write: Viết
Help: Cứu giúp
Could: Có thể
Given: Được
Cook: Nấu ăn
Cool: Mát mẻ
Self: Tự
Confront: Đối đầu
Mechanism: Cơ chế
Wrist: Cổ tay
Reduction: Giảm
Fragile: Mong manh
Thereby: Bằng cách ấy
Sell: Bán
Lawmaker: Nhà lập pháp
Donation: Quyên góp
Disappear: Biến mất
Export: Xuất khẩu
Regime: Chế độ
Administration: Quản trị
Priest: Thầy tu
Magnet: Nam châm
Slight: Nhẹ
Reporter: Phóng viên
Expose: Lộ ra
Stable: Ổn định
Concentration: Sự tập trung
Versus: Đấu với
Detective: Thám tử
Found: Tìm
Pregnancy: Mang thai
Sensitivity: Nhạy cảm
Type: Kiểu
Held: Được tổ chức
Breast: Nhũ hoa
Diabetes: Bệnh tiểu đường
Funny: Buồn cười
None: Không ai
Hell: Địa ngục
Cream: Kem
Critical: Chỉ trích
Uniform: Đồng phục
Send: Gửi
Eight: Tám
Input: Đầu vào
Like: Như
Creative: Sáng tạo
Introduce: Giới thiệu
Breath: Hơi thở
Manufacturer: Nhà chế tạo
Yours: Của bạn
Job: Việc làm
Cord: Dây
Core: Cốt lõi
Sent: Gởi
Opposite: Đối diện
Unite: Thống nhất
Cope: Đối phó
Environmental: Môi trường
Noon: Trưa
Priority: Sự ưu tiên
Queen: Nữ hoàng
Conception: Quan niệm
Contemporary: Đồng thời
Drinking: Uống
Youth: Thiếu niên
Manipulate: Vận dụng
Dare: Dám
Unity: Thống nhất
Copy: Sao chép
Joy: Vui sướng
Dark: Tối
Sad: Buồn
Resolution: Độ phân giải
Acceptance: Chấp thuận
Ownership: Sở hữu
Uncertainty: Tính không chắc chắn
Friendly: Thân thiện
Wild: Hoang dã
Volunteer: Tình nguyện
Sat: Ngồi
Saw: Cái cưa
Digital: Kỹ thuật số
Say: Nói
Blow: Thổi
Cost: Giá cả
Snap: Chụp nhanh
Recent: Gần đây
Twist: Xoắn
Required: Cần thiết
Limb: Chân tay
Nose: Mũi
Alliance: Liên minh
Will: Sẽ
Drug: Thuốc uống
Bad: Xấu
Drum: Trống
Famous: Nổi danh
Corn: Ngô
Bag: Túi
Data: Dữ liệu
Drown: Chết chìm
Ban: Lệnh cấm
Date: Ngày
Weather: Thời tiết
Bar: Quán ba
Tolerate: Tha thứ
Bat: Gậy
Second: Thứ hai
Single: Độc thân
Norm: Định mức
Skull: Sọ
Bay: Bay
Regulate: Quy định
Contribution: Sự đóng góp
Session: Phiên họp
Heart: Tim
Wine: Rượu nho
Wind: Gió
Wing: Canh
Buck: Buck
Airline: Hãng hàng không
Customer: Khách hàng
Incredibly: Vô cùng
Coup: Cuộc đảo chính
Much: Nhiều
Republican: Nhà nước cộng hòa
Laboratory: Phòng thí nghiệm
Towards: Về hướng
Success: Sự thành công
Interview: Phỏng vấn
Otherwise: Nếu không thì
Dawn: Bình minh
Button: Nút
Thus: Do đó
Lion: Sư tử
Shorts: Quần short
Prosecutor: Công tố viên
Incredible: Đáng kinh ngạc
Fence: Hàng rào
Integrated: Tích hợp
Scholarship: Học bổng
Noun: Danh từ
Anger: Sự phẫn nộ
Space: Không gian
Palace: Cung điện
Angel: Thiên thần
Arab: Arab
Chase: Đuổi theo
Rough: Thô
Sea: Biển
Herb: Thảo mộc
Tight: Chặt chẽ
Heard: Nghe
Line: Hàng
Quarterback: Tiền vệ
Experience: Kinh nghiệm
Here: Đây
See: Xem
Chemical: Hóa chất
Note: Chú thích
Hero: Anh hùng
Nutrient: Chất dinh dưỡng
Constitute: Cấu tạo
Reform: Cải cách
Spite: Bất bình
Hers: Của cô ấy
Ancestor: Tổ tiên
Link: Liên kết
Began: Bắt đầu
Set: Bộ
Wrap: Bọc
Increasing: Tăng
Bible: Kinh thánh
Sex: Tình dục
Logical: Hợp lý
Proceed: Tiếp tục
Spray: Xịt nước
Wipe: Lau
Shallow: Nông
Charm: Quyến rũ
Strange: Kỳ lạ
Typically: Thường
Allegation: Cáo buộc
Exploit: Khai thác
Season: Mùa
Workout: Tập thể dục
Chart: Đồ thị
Hazard: Nguy hiểm
Bed: Giường
Mineral: Khoáng sản
Pleased: Vừa lòng
Bee: Con ong
Beg: Ăn xin
Blue: Màu xanh da trời
Courage: Lòng can đảm
Iraqi: Iraqi
Tropical: Nhiệt đới
Reporting: Báo cáo
Anybody: Bất kỳ ai
Bet: Cá cược
Holiday: Ngày lễ
Curriculum: Chương trình giáo dục
Your: Của bạn
Drift: Trôi dạt
Diagnose: Chẩn đoán
Career: Nghề nghiệp
Chaos: Hỗn loạn
Heavy: Nặng
Neutral: Trung tính
Spine: Xương sống
Likelihood: Khả năng
Shortly: Ngay
Around: Xung quanh
Collective: Tập thể
Wire: Dây điện
Metaphor: Phép ẩn dụ
Complexity: Phức tạp
She: Chị ấy
Happily: Hạnh phúc
Insight: Cái nhìn sâu sắc
Lack: Thiếu sót
List: Danh sách
Profit: Lợi nhuận
Lovely: Đáng yêu
Protection: Sự bảo vệ
Alike: Như nhau
Collar: Cổ áo
Shy: Nhát
Interaction: Sự tương tác
Dried: Khô
Phrase: Cụm từ
Saving (pl): Tiết kiệm (pl)
Area: Khu vực
Because: Bởi vì
University: Trường đại học
Early: Sớm
Sin: Tội
Loyalty: Lòng trung thành
Sir: Ngài
Sit: Ngồi
Adapt: Phỏng theo
Six: Sáu
Industrial: Công nghiệp
Corporate: Công ty
Deploy: Triển khai
Mathematics: Toán học
Organized: Tổ chức
Spill: Tràn
Brush: Chải
Radical: Cấp tiến, căn nguyên
Lady: Quý bà
Processing: Chế biến
With: Với
Sexy: Sexy
Quietly: Lặng lẽ
Biography: Tiểu sử
Peak: Cao điểm
Controversial: Gây tranh cãi
Children: Bọn trẻ
Bid: Bid
Squad: Đội hình
Million: Triệu
Leading: Dẫn đầu
Big: Lớn
Withdraw: Thu hồi
Colonial: Thuộc địa
Historic: Mang tính lịch sử
Physician: Bác sĩ
Bicycle: Xe đạp
Bit: Bit
Wise: Khôn ngoan
Wish: Muốn
Ski: Trượt tuyết
Crowded: Đông người
Regard: Quan tâm
Expect: Chờ đợi
Possession: Chiếm hữu
Expedition: Thám hiểm
Relieve: Giải tỏa
Sky: Bầu trời
Birthday: Sinh nhật
Profound: Thâm thúy
Already: Đã
Muslim: Hồi giáo
Motive: Động cơ
Complain: Than phiền
Despite: Mặc dù
Virtue: Đức hạnh
Membership: Thành viên
Even: Cũng
Firmly: Vững chắc
Lawyer: Luật sư
Distance: Khoảng cách
Accessible: Có thể truy cập
Ever: Không bao giờ
Adjustment: Điều chỉnh
Somebody: Có ai
Director: Giám đốc
Live: Trực tiếp
Bull: Con bò
Bulk: Số lượng lớn
Island: Đảo
Tomorrow: Ngày mai
Trail: Đường mòn
Bulb: Bóng đèn
Useful: Hữu ích
Gently: Dịu dàng
Trait: Đặc điểm
Train: Xe lửa
Willing: Sẵn lòng
Chain: Chuỗi
Minimum: Tối thiểu
Bathroom: Phòng tắm
Chair: Cái ghế
Instructor: Giảng viên
Rabbit: Con thỏ
Confirm: Xác nhận
Conversation: Cuộc hội thoại
Brilliant: Rực rỡ
Uncover: Khám phá
Energy: Năng lượng
Gentle: Dịu dàng
Peel: Lột vỏ
Worker: Công nhân
Initiate: Bắt đầu
Majority: Đa số
Alien: Người ngoài hành tinh
Purse: Cái ví
Wage: Tiền lương
Seize: Tịch thu
Acquire: Có được, thu được
Government: Chính quyền
Thumb: Ngón tay cái
Butter: Bơ
Steep: Dốc
Educational: Giáo dục
Roman: Roman
Altogether: Hoàn toàn
Steel: Thép
Unfold: Mở ra
Son: Con trai
Expression: Biểu hiện
Terrain: Địa hình
Steer: Chỉ đạo
Likewise: Tương tự
Essence: Bản chất
Organ: Đàn organ
Homeland: Quê hương
Politically: Chính trị
Loyal: Trung thành
Perform: Biểu diễn
Snow: Tuyết
Sympathy: Cảm thông
Exclusive: Độc quyền
Illusion: Ảo giác
Lake: Hồ
Elite: Ưu tú
Essential: Cần thiết
Implication: Hàm ý
Result: Kết quả
Trade: Buôn bán
Dissolve: Giải thể
Evil: Tà ác
Ideology: Hệ tư tưởng
Spy: Gián điệp
Doctrine: Học thuyết
Addition: Thêm vào
Army: Quân đội
Democratic: Dân chủ
Peer: Ngang nhau
Announce: Tuyên bố
Box: Cái hộp
Bow: Cây cung
Widely: Rộng rãi
Boy: Con trai
Debut: Ra mắt
Protective: Bảo vệ
Preserve: Giữ gìn
Price: Giá bán
Originally: Ban đầu
Value: Giá trị
Collection: Bộ sưu tập
Relevant: Liên quan, thích hợp
Grandmother: Bà ngoại
Wait: Chờ đợi
Eleven: Mười một
Ethnic: Dân tộc
Walk: Đi bộ
Destination: Nơi đến
Wall: Tường
Canadian: Người canada
Constant: Không thay đổi
Unhappy: Không vui
Clean: Dọn dẹp
Information: Thông tin
County: Quận
Clear: Trong sáng
Succeed: Thành công
Directly: Trực tiếp
Pride: Tự hào
Warmth: Ấm áp
Horizon: Đường chân trời
Round: Tròn
Preach: Rao giảng
Weave: Dệt
Lamp: Đèn
Finish: Hoàn thành
Readily: Dễ dàng
Stead: Thay thế
Bury: Chôn
Necessity: Sự cần thiết
Steal: Lấy trộm
Error: Lỗi
Steak: Miếng bò hầm
Wake: Đánh thức
Painting: Bức vẽ
Burn: Đốt cháy
Decline: Từ chối
Trace: Dấu vết
Tide: Thủy triều
Reading: Đọc hiểu
Steam: Hơi nước
Paper: Giấy
Regain: Giành lại
Track: Theo dõi
Resume: Tiếp tục
Wealth: Sự giàu có
Vertical: Theo chiều dọc
Owner: Chủ nhân
Busy: Bận
Ceiling: Trần nhà
Driving: Điều khiển
Extended: Mở rộng
History: Lịch sử
Must: Phải
Civilian: Dân thường
Print: In
Distinct: Khác biệt
Actively: Tích cực
Departure: Khởi hành
Weakness: Yếu đuối
Bush: Cây bụi
Imagine: Tưởng tượng
Measure: Đo
Coastal: Duyên hải
Want: Muốn
Importantly: Quan trọng
Marriage: Kết hôn
Relief: Cứu trợ
Tablespoon: Muỗng canh
Instantly: Ngay lập tức
Equally: Bằng nhau
Sue: Kiện
Regularly: Thường xuyên
Anymore: Nữa không
Lane: Lane
Absence: Vắng mặt
Completely: Hoàn toàn
Circuit: Mạch
Sum: Tổng hợp
Butt: Mông
Smile: Nụ cười
Billion: Tỷ
Sun: Mặt trời
Serve: Phục vụ
Fewer: Ít hơn
Land: Đất đai
Participant: Người tham gia
Prior: Trước
Cooperate: Hợp tác
Inventory: Hàng tồn kho
Key: Chìa khóa
Office: Văn phòng
Psychological: Tâm lý
Inspiration: Cảm hứng
Estimate: Ước tính
March: Tháng ba
Cotton: Bông
Suicide: Tự tử
Horrible: Kinh khủng
Bug: Lỗi
Radar: Radar
Military: Quân đội
But: Nhưng
Bullet: Đạn
Bus: Xe buýt
Ahead: Phía trước
Buy: Mua
Calendar: Lịch
Mushroom: Nấm
Classic: Cổ điển
Characterize: Đặc trưng
Forbid: Ngăn cấm
Photography: Nhiếp ảnh
Spare: Phụ tùng
Comfort: Thoải mái
Event: Biến cố
Reply: Đáp lại
Spark: Tia lửa
Climate: Khí hậu
Triumph: Triumph
Process: Quá trình
Viewer: Người xem
Warm: Ấm áp
Swim: Bơi
Warn: Cảnh báo
Serving: Phục vụ
Last: Cuối cùng
Offensive: Phản cảm
Overcome: Vượt qua
Tragic: Bi kịch
Limitation: Giới hạn
Wash: Rửa
Participate: Tham dự
First: Đầu tiên
Remaining: Còn lại
Selfesteem: Lòng tự trọng
Route: Lộ trình
Bronze: Đồng
Epidemic: Bệnh dịch
Poverty: Nghèo nàn
Program: Chương trình
Architecture: Kiến trúc
Particular: Cụ thể
Deputy: Phó
Legislation: Pháp luật
Mortality: Tử vong
Kid: Đứa trẻ
Senator: Thượng nghị sĩ
Establishment: Thành lập
Kit: Bộ dụng cụ
Speculate: Suy đoán
Investigate: Điều tra
Salary: Lương
Arrest: Bắt giữ
Diplomatic: Ngoại giao
Prime: Nguyên tố
Secretary: Thư ký
Expert: Chuyên gia
Necessarily: Nhất thiết
Emission: Khí thải
Mentor: Người cố vấn
Circumstance: Tình huống
Time: Thời gian
Whether: Liệu
Privately: Tư nhân
Disability: Khuyết tật
Control: Điều khiển
Corner: Góc
Honest: Thật thà
Electricity: Điện
Boyfriend: Bạn trai
Branch: Chi nhánh
Eating: Ăn
Objection: Sự phản đối
Stomach: Dạ dày
Confession: Lời thú tội
Late: Muộn
Transmit: Chuyển giao
Chill: Làm lạnh
Sponsor: Nhà tài trợ
Tile: Ngói
Sudden: Đột nhiên
Neither: Cũng không
Burning: Đốt
Till: Cho đến
Every: Mỗi
Populate: Cư trú
Speech: Phát biểu
Rally: Biểu tình
Recover: Bình phục
Reliability: Độ tin cậy
Monument: Tượng đài
Dictate: Điều khiển
Mental: Tâm thần
Awareness: Nhận thức
Tiny: Nhỏ bé
Lawn: Bãi cỏ
Projection: Chiếu
Deserve: Xứng đáng
Security: Bảo vệ
Admire: Ngưỡng mộ
Fragment: Miếng
Conventional: Thông thường
Okay: Đuợc
Capacity: Sức chứa
Inmate: Tù nhân
Child: Đứa trẻ
Translate: Dịch
Where are you from ?: May den tu dau ?
Automobile: Ôtô
Jacket: Áo khoác
Vote: Bỏ phiếu
Proposed: Đề xuất
Minimal: Tối thiểu
Wave: Làn sóng
Survey: Khảo sát
Preference: Sở thích
Investment: Đầu tư
Explore: Khám phá
Occur: Xảy ra
Birth: Sinh
Complex: Phức tạp
Contain: Chứa
Partner: Cộng sự
Fighter: Đấu sĩ
Realistic: Thực tế
Ridiculous: Nực cười
Testify: Làm chứng
Appreciate: Đánh giá
Korean: Hàn quốc
Fraction: Phân số
Radio: Radio
Trap: Bẩy
Doctor: Bác sĩ
Everybody: Mọi người
Prize: Giải thưởng
Chance: Cơ hội
Tray: Cái mâm
Marketplace: Thương trường
Partnership: Hợp tác
Ingredient: Thành phần
Tag: Nhãn
Farmer: Nông phu
Encouraging: Khuyến khích
Soak: Ngâm
Optimistic: Lạc quan
Tap: Gõ
Appreciation: Sự đánh giá
Soar: Bay lên
Tax: Thuế
Soap: Xà bông
Moment: Chốc lát
Democrat: Dân chủ
Cause: Nguyên nhân
Tree: Cây
Muscle: Cơ bắp
Client: Khách hàng
Differently: Khác
Hallway: Hành lang
Testing: Thử nghiệm
Cab: Taxi
Resource: Tài nguyên
Province: Tỉnh
Tire: Lốp xe
Can: Có thể
Objective: Mục tiêu
Necessary: Cần thiết
Cap: Mũ lưỡi trai
Car: Xe hơi
Cat: Con mèo
Poster: Áp phích
Environment: Môi trường
Proposal: Đề nghị
Basic: Căn bản
Mean: Nghĩa là
Category: Thể loại
Separation: Tách biệt
Sock: Bít tất
Argument: Tranh luận
Chief: Giám đốc
Chef: Đầu bếp
Assessment: Thẩm định, lượng định, đánh giá
Meal: Bữa ăn
Science: Khoa học
Beat: Tiết tấu
Glad: Vui vẻ
Bear: Chịu
Trash: Rác
Source: Nguồn
Bean: Hạt đậu
Meat: Thịt
Beam: Chùm tia
Basis: Nền tảng
Typical: Điển hình
Column: Cột
Chew: Nhai
Since: Kể từ
Cognitive: Nhận thức
Punish: Trừng phạt
Apologize: Xin lỗi
Bureau: Phòng làm việc
Fruit: Trái cây
Notebook: Sổ tay
Service: Dịch vụ
Change: Thay đổi
Contact: Tiếp xúc
Tea: Trà
Convention: Quy ước
Extra: Thêm
Future: Tương lai
Ten: Mười
Appointment: Cuộc hẹn
Frustrate: Thất vọng
Repeat: Nói lại
Clock: Đồng hồ
Sofa: Ghế sô pha
Politician: Chính trị gia
Dialogue: Đối thoại
Everything: Mọi điều
Musician: Nhạc sĩ
Curtain: Tấm màn
Street: Đường phố
Tumor: Khối u
Squeeze: Bóp
Constitution: Hiến pháp
Status: Trạng thái
Glove: Găng tay
Consult: Tham khảo ý kiến
Cruise: Du lịch
Implement: Thực hiện
Biological: Sinh học
Discover: Khám phá
Ceo: Ceo
Exchange: Trao đổi, giao dịch
Ironically: Trớ trêu thay
Consume: Tiêu dùng
Peaceful: Bình yên
Hesitate: Do dự
Revelation: Sự mặc khải
Statue: Bức tượng
Jungle: Rừng nhiệt đới
Observe: Quan sát
Where: Ở đâu
Ad: Quảng cáo
Meet: Gặp
Missionary: Nhà truyền giáo
Authority: Thẩm quyền
Ah: Ah
Involvement: Sự tham gia
Chin: Cái cằm
Am: Là
Chip: Chip
An: Một
Machine: Máy móc
Beer: Bia
The: Các
Tissue: Mô
As: Như
At: Tại
Been: Đã
Merchant: Thương gia
Properly: Đúng
Sprinkle: Rắc
Output: Đầu ra
Tail: Đuôi
Feather: Lông vũ
Inspector: Thanh tra
Beef: Thịt bò
Graduate: Tốt nghiệp
Elbow: Khuỷu tay
Trip: Chuyến đi
Be: Được
Trim: Cắt tỉa
Brutal: Tàn bạo
Average: Trung bình cộng
Jump: Nhảy
Soft: Mềm mại
Invasion: Cuộc xâm lăng
Enforcement: Thực thi
Tie: Cà vạt
Register: Ghi danh
By: Bởi
Meanwhile: Trong khi đó
Tip: Tiền boa
Take: Lấy
Doorway: Lối vào
Somehow: Bằng cách nào đó
Interfere: Gây trở ngại
Therapist: Nhà trị liệu
Worth: Giá trị
Pollution: Sự ô nhiễm
Swimming: Bơi lội
Acknowledge: Công nhận
Do: Làm
Marker: Đánh dấu
Market: Thị trường
Authorize: Cho phép
Diverse: Phong phú
Storage: Lưu trữ
Mechanical: Cơ khí
Socalled: Cái gọi là
Little: Ít
Soil: Đất
Taste: Nếm thử
Ourselves: Chúng ta
Worry: Lo
Hole: Lỗ
Overwhelm: Quá tải
Cheese: Phô mai
Iron: Bàn là
During: Suốt trong
Jury: Ban bồi thẩm
Sole: Duy nhất
Annual: Hàng năm
Holy: Thánh
Mouth: Miệng
Home: Nhà
Approve: Tán thành
Condition: Điều kiện
Tale: Câu chuyện
Horror: Kinh dị
Shareholder: Cổ đông
Replacement: Thay thế
Tall: Cao
Truck: Xe tải
Talk: Nói chuyện
Launch: Phóng
Identify: Nhận định
Pizza: Pizza
Candle: Nến
Liability: Trách nhiệm pháp lý
Mouse: Chuột
Indian: Người ấn độ
Previous: Trước
Seller: Người bán
Sustainable: Bền vững
Hold: Giữ
Chop: Chặt
Go: Đi
Accuse: Tố cáo
Nerve: Dây thần kinh
Song: Bài hát
Ha: Ha
Hidden: Ẩn
Shelter: Nơi trú ẩn
Steadily: Liên tục
He: Anh ta
Wonder: Ngạc nhiên
Yourself: Bản thân bạn
Hi: Chào
Fleet: Hạm đội
Capability: Khả năng
Whatever: Bất cứ điều gì
Publication: Xuất bản
Toe: Ngón chân
Student: Sinh viên
Tank: Xe tăng
Unemployment: Thất nghiệp
Just: Chỉ
Southwest: Tây nam
Some: Một số
Belt: Thắt lưng
Top: Hàng đầu
Senior: Cao cấp
Too: Quá
Olympics: Thế vận hội
Distribution: Phân phối
Official: Chính thức
Medical: Y khoa
Suffering: Đau khổ
Timing: Thời gian
Bell: Chuông
Ie: Nghĩa là
If: Nếu
Journey: Hành trình
Person: Người
Automatic: Tự động
Toy: Đồ chơi
Trunk: Thân cây
In: Trong
Bend: Bẻ cong
Inform: Thông báo
Behalf: Thay mặt
Is: Là
It: Nó
Flexibility: Mềm dẻo
Strengthen: Củng cố
Repeatedly: Nhiều lần
Interesting: Hấp dẫn
Signal: Tín hiệu
Target: Mục tiêu
Feeling: Cảm giác
Slide: Trượt
Style: Phong cách
Menu: Thực đơn
Reputation: Uy tín
Property: Bất động sản
Hook: Cái móc
Melt: Tan chảy
Able: Có thể
Cop: Cảnh sát
Tape: Băng
Living: Sống
Amount: Số lượng
Concern: Mối quan ngại
Meantime: Thời gian chờ đợi
Cow: Bò
Lab: Phòng thí nghiệm
Cease: Ngưng
Concert: Buổi hòa nhạc
Chronic: Mãn tính
Tunnel: Đường hầm
Realize: Nhận ra
Illness: Bệnh
Enterprise: Doanh nghiệp
Receive: Nhận được
Lap: Vòng
Soon: Sớm
Favorable: Thuận lợi
Variety: Đa dạng
Hope: Mong
Horn: Sừng
Fill: Lấp đầy
Task: Bài tập
Law: Pháp luật
Tactic: Chiến thuật
Film: Phim ảnh
Lay: Đặt nằm
Depict: Miêu tả
Talented: Có tài
True: Thật
Journal: Tạp chí
Rather: Hơn
Boundary: Ranh giới
Enough: Đủ
Reality: Thực tế
Spread: Lan tràn
Trigger: Cò súng
Motivation: Động lực
Notice: Để ý
Waist: Eo
Sort: Sắp xếp
Try: Thử
Availability: Khả dụng
Concept: Khái niệm
Pension: Lương hưu
Instruct: Dạy
Player: Người chơi
Adviser: Cố vấn
Experiment: Thí nghiệm
Calculate: Tính toán
Invent: Phát minh
Secret: Bí mật
Piano: Đàn piano
Truly: Thực sự
Drama: Kịch
Sodium: Natri
Introduction: Giới thiệu
Suspicious: Nghi ngờ
Slice: Lát
Understand: Hiểu không
Me: Tôi
Organizational: Tổ chức
Balance: Cân đối
File: Tập tin
Grief: Đau buồn
Mr: Ông
Ms: Cô
Mostly: Chủ yếu
Endorse: Chứng thực
Cry: Khóc
Relatively: Tương đối
Committee: Ủy ban
My: Tôi
Mere: Chỉ là
Clothe: Trang phục
Entrance: Cổng vào
Commodity: Hàng hóa
Phone: Điện thoại
Understanding: Hiểu biết
Record: Ghi lại
Accurately: Chính xác
Framework: Khuôn khổ
Behavioral: Hành vi
No: Không
Rebel: Nổi loạn
Explain: Giải thích
Dozen: Tá
Host: Chủ nhà
Led: Dẫn
Virtual: Ảo
Specific: Riêng
Vendor: Nhà cung cấp
Talent: Năng lực
Stress: Nhấn mạnh
Leg: Chân
Aware: Ý thức
Award: Giải thưởng
Alarm: Báo thức
Of: Của
Find: Tìm thấy
Instrument: Dụng cụ
Oh: Oh
Sheep: Cừu
Strategy: Chiến lược
Let: Để cho
N't: Không
Perhaps: Có lẽ
Fine: Khỏe
Ok: Được
Sheet: Tấm
Handsome: Đẹp
On: Trên
Sheer: Tuyệt
Or: Hoặc là
Precise: Tóm lược
Residential: Nhà ở
Front: Trước mặt
Automatically: Tự động
Cue: Gợi ý
Assert: Khẳng định
Pc: Pc
Consumer: Khách hàng
Unfair: Không công bằng
Favor: Ủng hộ
Swing: Lung lay
Best: Tốt
Rifle: Súng trường
Pm: Pm
Cup: Tách
Hunter: Thợ săn
Cut: Cắt tỉa
Astronomer: Nhà thiên văn học
Hour: Giờ
Instant: Tức thời
Civic: Công dân
Drain: Ráo nước
Two: Hai
Soup: Súp
Civil: Dân sự
Clearly: Thông suốt
Soul: Linh hồn
Volume: Âm lượng
Chicken: Gà
Mess: Lộn xộn
Slavery: Chế độ nô lệ
Angry: Bực bội
Biology: Sinh học
Possibility: Khả năng
Starter: Bắt đầu
Historically: Lịch sử
Parish: Giáo xứ
Royal: Hoàng tộc
Re: Lại
Ethical: Đạo đức
Shoulder: Vai
Infrastructure: Cơ sở hạ tầng
Enable: Cho phép
Fish: Cá
Lifestyle: Lối sống
Employ: Thuê
Face: Đối mặt
Beside: Bên cạnh
Rural: Nông thôn
Teenage: Thiếu niên
Abroad: Ở nước ngoài
Abuse: Lạm dụng
Persuade: Truy vấn
Lid: Nắp
Lie: Nói dối
Ballot: Phiếu
Tragedy: Bi kịch
Figure: Nhân vật
Restaurant: Nhà hàng
Draft: Bản nháp
Lip: Môi
Fire: Ngọn lửa
Yield: Năng suất
So: Vì thế
Writer: Nhà văn
Firm: Chắc chắn
Other: Khác
Preliminary: Sơ bộ
Throat: Họng
Commission: Uỷ ban
Label: Nhãn
Photo: Hình chụp
Sleeve: Tay áo
Delay: Sự chậm trễ
Parade: Diễu hành
Uncertain: Không chắc chắn
Negative: Tiêu cực
Battery: Ắc quy
Drive: Lái xe
Guard: Bảo vệ
To: Đến
Disabled: Tàn tật
Install: Cài đặt, dựng lên
Avoid: Tránh
Truth: Sự thật
Economics: Kinh tế học
Evaluation: Đánh giá
Tv: Tv
Mentally: Tinh thần
Clothing: Quần áo
Fist: Nắm tay
Policeman: Cảnh sát
Harsh: Khắc nghiệt
Dancer: Vũ công
Downtown: Trung tâm thành phố
Fact: Thực tế
Free: Miễn phí
Awake: Thức tỉnh
Fantastic: Tuyệt diệu
Score: Ghi bàn
Uh: Uh
Decrease: Giảm bớt
Spouse: Vợ / chồng
Individual: Cá nhân
Observation: Quan sát
Problem: Vấn đề
Up: Lên
Fade: Phai màu
Us: Chúng tôi
Beauty: Sắc đẹp, vẻ đẹp
Operator: Nhà điều hành
Fulltime: Toàn thời gian
Destruction: Sự phá hủy
Shelf: Kệ
Factory: Nhà máy
Rapidly: Nhanh chóng
Twothirds: Hai phần ba
Anywhere: Ở đâu
Decorate: Trang trí
Basketball: Bóng rổ
Fishing: Đánh bắt cá
Situation: Tình hình
Southeast: Đông nam
System: Hệ thống
Shell: Vỏ
Columnist: Nhà bình luận viên
Relate: Liên hệ
Flesh: Xác thịt
Improved: Cải tiến
Impulse: Thúc đẩy
Vs: Vs
Suddenly: Đột ngột
Jeans: Quần jean
Franchise: Nhượng quyền thương mại
Trust: Lòng tin
Penalty: Hình phạt
We: Chúng tôi
Ruin: Phá hoại
Gifted: Năng khiếu
Quote: Trích dẫn
Assess: Đánh giá
Constitutional: Hiến pháp
Five: Số năm
Scope: Phạm vi
Battle: Chiến đấu
Filter: Lọc
Laser: Laser
Sorry: Lấy làm tiếc
Within: Bên trong
Mutter: Lẩm bẩm
Pasta: Mỳ ống
Discourage: Gây chán nản cho
Reward: Phần thưởng
Await: Chờ đợi
Emotionally: Tình cảm
Monthly: Hàng tháng
Behind: Phía sau
Perceive: Nhận thức
Break: Phá vỡ
Carpet: Thảm
Detect: Phát hiện
Shared: Chia sẻ
Bread: Bánh mỳ
Privacy: Riêng tư
Frown: Nhăn mặt
Medication: Thuốc men
Failure: Thất bại
Fail: Thất bại
Poem: Bài thơ
Uncle: Chú
Log: Đăng nhập
Connect: Kết nối
Hopefully: Hy vọng
Definition: Định nghĩa
Poet: Bài thơ
Local: Địa phương
Fairly: Công bằng
Initially: Ban đầu
Worldwide: Trên toàn thế giới
Seven: Bảy
Concede: Công nhận
Survival: Sự sống còn
Cycle: Chu kỳ
Treat: Đãi
Lot: Nhiều
Station: Ga tàu
Tobacco: Thuốc lá
Suspicion: Nghi ngờ
Hence: Vì thế
Low: Thấp
Always: Luôn luôn
Rule: Qui định
Scholar: Học giả
Tough: Khó khăn
Research: Nghiên cứu
Particularly: Đặc biệt
Friend: Người bạn
Without: Không có
Begin: Bắt đầu
Nice: Tốt đẹp
Passenger: Hành khách
Movie: Bộ phim
Fair: Hội chợ
Dad: Cha
Crowd: Đám đông
Alive: Sống sót
Dam: Con đập
Angle: Góc
Speak: Nói
Entitle: Quyền lợi
Prompt: Nhắc nhở
Persist: Tồn tại
Significantly: Đáng kể
Day: Ngày
Removal: Gỡ bỏ
Ignore: Bỏ qua
Intelligence: Sự thông minh
Grace: Ân sủng
Regulatory: Quy định
Drink: Uống
Fame: Danh tiếng
Vacuum: Khoảng chân không
Gesture: Cử chỉ
Candy: Cục kẹo
Behavior: Hành vi
Cemetery: Nghĩa trang
Musical: Âm nhạc
Assistance: Hỗ trợ
Culture: Nền văn hóa
Poke: Xô
Consumption: Tiêu dùng
Impact: Va chạm
Outsider: Người ngoài
Daughter: Con gái
Scientist: Nhà khoa học
Grade: Cấp
Funeral: Tang lễ
Hardly: Khó khăn
Performer: Người biểu diễn
Equivalent: Tương đương
Fall: Ngã
Mainstream: Dòng chính
Scatter: Tiêu tan
Message: Thông điệp
Permanent: Dài hạn
Cross: Vượt qua
Drill: Máy khoan
Confusion: Sự nhầm lẫn
Touch: Chạm
Earth: Trái đất
Clerk: Nhân viên bán hàng
Bunch: Bó
Collector: Người thu gom
Rhetoric: Hùng biện
Electrical: Điện
Visual: Trực quan
Rush: Vội vã
Until: Cho đến
Seminar: Hội thảo
Stimulus: Kích thích kinh tế
Mansion: Biệt thự
Increase: Tăng
From: Từ
Spirit: Tinh thần
Tender: Đấu thầu
Sandwich: Sandwich
Today: Hôm nay
Treatment: Điều trị
Poll: Thăm dò ý kiến
Summary: Tóm lược
Politics: Chính trị
Ongoing: Đang diễn ra
Fourth: Thứ tư
Formation: Sự hình thành
Grandparent: Ông bà
Pole: Cây sào
Integrity: Chính trực
Technological: Công nghệ
Entity: Thực thể
Storm: Bão táp
Fortunately: May mắn
Jewelry: Đồ trang sức
Store: Cửa hàng
Across: Băng qua
Insert: Chèn
Bright: Sáng
Correctly: Đúng
Physical: Vật lý
Secular: Thế tục
Armed: Trang bị
Consent: Bằng lòng
Ranch: Trang trại
Compensation: Đền bù
Naval: Hải quân
Pool: Bơi
Story: Câu chuyện
Exam: Thi
Aisle: Lối đi
Motor: Động cơ
Landmark: Mốc
Violent: Hung bạo
Bonus: Thưởng
Confrontation: Đối đầu
Alter: Thay đổi
Generation: Thế hệ
Pond: Ao
Devil: Ác quỷ
Publicity: Công khai
Reportedly: Báo cáo
Transfer: Chuyển khoản
Consideration: Xem xét
Spin: Quay
Theory: Lý thuyết
Innocent: Vô tội
Broke: Đã phá vỡ
Maker: Nhà sản xuất
Spit: Nhổ
Comparison: So sánh
Intellectual: Trí tuệ
Ocean: Đại dương
Budget: Ngân sách
Debris: Mảnh vụn
Fast: Nhanh
Did: Đã làm
Pants (pl): Quần (pl)
Upper: Phía trên
Die: Chết
Dig: Đào
Grateful: Tri ân
Poor: Nghèo nàn
Terrorism: Khủng bố
Aggression: Hiếu chiến
Assemble: Tập hợp
Dip: Nhúng
Publisher: Nhà xuất bản
Offense: Xúc phạm
Quest: Nhiệm vụ
Fare: Giá vé
Increasingly: Ngày càng
Better: Tốt hơn
Defender: Hậu vệ
Farm: Nông trại
Correspondent: Phóng viên
Sometime: Thỉnh thoảng
Father: Cha
Terrorist: Khủng bố
Place: Địa điểm
Depending: Tùy
Routinely: Thường
Port: Hải cảng
Difference: Sự khác biệt
Responsibility: Trách nhiệm
Stone: Cục đá
Descend: Hạ xuống
Retail: Bán lẻ
Hello: Xin chào
Version: Phiên bản
Cooperation: Hợp tác
Pose: Đặt ra
Retain: Giữ lại
Defeat: Đánh bại
Various: Nhiều
Though: Tuy nhiên
Incentive: Khuyến khích
Festival: Lễ hội
Wherever: Ở đâu
Attitude: Thái độ
Maintenance: Bảo trì
Paint: Sơn
Stood: Đứng
Arrival: Sự đến
Scene: Bối cảnh
Fate: Số phận
Silver: Bạc
Distract: Làm mất tập trung
Emotional: Đa cảm
Dismiss: Bỏ qua
Scent: Hương thơm
Crucial: Quan trọng
Pork: Thịt heo
Sensor: Cảm biến
Acid: Axit
Rating: Xêp hạng
Excessive: Quá đáng
Suspend: Đình chỉ
Outside: Ở ngoài
Number: Con số
Unable: Không thể
Donate: Hiến tặng
Enact: Ban hành
Pour: Đổ
Dangerous: Nguy hiểm
Tremendous: To lớn
Garden: Vườn
Strictly: Nghiêm khắc
Appeal: Kháng cáo
Post: Bài đăng
Residence: Nơi cư trú
Although: Mặc dù
Middle: Ở giữa
Diplomat: Nhà ngoại giao
Consonant: Phụ âm
Command: Chỉ huy
Dna: Dna
Nine: Chín
Schedule: Kế hoạch
Duck: Con vịt
Appear: Xuất hiện
Midnight: Nữa đêm
Arrange: Sắp xếp
Elderly: Người lớn tuổi
Professor: Giáo sư
Fresh: Tươi
Address: Địa chỉ nhà
Spot: Nơi
Flight: Chuyến bay
Plural: Số nhiều
Throughout: Khắp
False: Sai
Tired: Mệt mỏi
Celebrity: Người nổi tiếng
Discuss: Bàn luận
Calculation: Phép tính
Private: Riêng tư
Dog: Chó
Exit: Lối thoát
Hormone: Hoocmon
Position: Chức vụ
Intensity: Cường độ
Dot: Dấu chấm
Reflection: Sự phản chiếu
Workplace: Nơi làm việc
Provoke: Kích động
Recommendation: Sự giới thiệu
Perfect: Hoàn hảo
Mad: Điên
Ready: Sẳn sàng
Plain: Trơn
Yellow: Màu vàng
Endure: Chịu đựng
Man: Đàn ông
Application: Ứng dụng
Map: Bản đồ
Interval: Khoảng thời gian
Discount: Giảm giá
May: Tháng năm
Cancel: Hủy bỏ
Govern: Quản lý
Civilization: Nền văn minh
Israeli: Israeli
Cite: Trích dẫn
River: Con sông
Division: Phân chia
Structure: Kết cấu
Solution: Dung dịch
Socially: Xã hội
Odds: Tỷ lệ
Surround: Vây quanh
Withdrawal: Thu hồi
Use: Sử dụng
Modify: Sửa đổi
Atop: Trên
Routine: Công việt hằng ngày
Atom: Nguyên tử
Temple: Ngôi đền
Reflect: Phản chiếu
Frankly: Thẳng thắn
Allegedly: Bị cáo buộc
Genius: Thiên tài
Tournament: Giải đấu
Boat: Thuyền
Cancer: Ung thư
Fitness: Sự tập thể dục
Interpret: Thông dịch
Probably: Có lẽ
Elegant: Thanh lịch
Album: Album
Retire: Về hưu
Dry: Khô
Unit: Đơn vị
Gear: Hộp số
Read: Đọc
Reservation: Đặt phòng
Differ: Khác nhau
Real: Thực
Palestinian: Palestine
Crew: Phi hành đoàn
Organic: Hữu cơ
Fluid: Chất lỏng
Teeth: Răng
Invitation: Lời mời
City: Thành phố
Range: Phạm vi
Seldom: Ít khi
Pressure: Sức ép
Successful: Thành công
Banana: Trái chuối
Probable: Có khả năng
Demographic: Nhân khẩu học
Broad: Rộng lớn
Perfectly: Hoàn hảo
Coalition: Liên minh
Men: Đàn ông
Textbook: Sách giáo khoa
Laughter: Tiếng cười
Except: Ngoại trừ
Sight: Thị giác
Cage: Cái lồng
Similar: Giống
Mistake: Sai lầm
Regulator: Người điều tiết
Match: Trận đấu
Engagement: Hôn ước
Increased: Tăng
Perspective: Quan điểm
Due: Đến hạn
Globe: Quả địa cầu
Childhood: Thời thơ ấu
Depart: Khởi hành
Manufacturing: Chế tạo
Body: Thân hình
Rival: Đối thủ
Reach: Chạm tới
Rear: Phía sau
Auction: Bán đấu giá
Cooperative: Hợp tác xã
Immediate: Ngay lập tức
Mode: Chế độ
Stretch: Căng ra
Compound: Hợp chất
Evolve: Phát triển
React: Phản ứng
Distinguish: Phân biệt
Barely: Vừa đủ
Commit: Cam kết
Shed: Đổ ra
Stove: Bếp
Cloud: Đám mây
Christian: Christian
Statistical: Thống kê
Undergraduate: Đại học
Extensive: Sâu rộng
Currently: Hiện tại
Reverse: Đảo ngược
Fault: Lỗi
Settle: Ổn định
Reject: Từ chối
Significant: Có ý nghĩa
Assure: Cam đoan
Daily: Hằng ngày
Nail: Móng tay
Remember: Nhớ lại
Counseling: Tư vấn
Mention: Đề cập đến
Cloth: Vải
Painter: Họa sĩ
Comedy: Phim hài
Tension: Căng thẳng
Damage: Hư hại
Cookie: Bánh quy
Dumb: Ngớ ngẩn
Transit: Quá cảnh
Dump: Đổ
Underlying: Cơ bản
Mutual: Lẫn nhau
Close: Gần
Eastern: Phương đông
Split: Phân chia
Mix: Pha trộn
Wheat: Lúa mì
Seemingly: Có vẻ
Kick: Đá
Cake: Bánh ngọt
Shit: Dơ bẩn
Refugee: Người tị nạn
Determination: Sự quyết tâm
Boil: Sôi lên
Simple: Đơn giản
Prevail: Chiếm ưu thế
Confident: Tự tin
Party: Buổi tiệc
Observer: Người quan sát
Agriculture: Nông nghiệp
Shuttle: Đưa đón
Vegetable: Rau
Communication: Giao tiếp
Calm: Điềm tĩnh
Provision: Điều khoản
Call: Gọi
Progress: Tiến độ
Convert: Đổi
Everyday: Mỗi ngày
Quickly: Mau
Reaction: Phản ứng
Section: Phần
Plate: Đĩa
Dedicate: Dâng hiến
Positive: Tích cực
Sixth: Thứ sáu
Consultant: Tư vấn
Garlic: Tỏi
Literary: Văn chương
Ship: Tàu
Simply: Đơn giản
Dutch: Người hà lan
Actually: Thực ra
Questionnaire: Bảng câu hỏi
Dollar: Đô la
Bitter: Đắng
Came: Đã đến
Seventh: Thứ bảy
Lemon: Chanh
Prosecution: Truy tố
Name: Tên
Trailer: Trailer
Crop: Mùa vụ
Industry: Ngành công nghiệp
Interest: Quan tâm
Supreme: Tối cao
Successfully: Thành công
Himself: Bản thân anh ấy
Significance: Tầm quan trọng
Another: Khác
Consciousness: Ý thức
Plane: Máy bay
Teacher: Giáo viên
Bolt: Chớp
Lucky: May mắn
Common: Chung
Please: Xin vui lòng
Worried: Lo lắng
Conflict: Cuộc xung đột
Offer: Phục vụ
Specifically: Đặc biệt
Revolutionary: Cách mạng
Actress: Nữ diễn viên
Bold: Dũng cảm
Internet: Internet
Camp: Trại
Symbolic: Tượng trưng
Invest: Đầu tư
Guide: Hướng dẫn
Combine: Phối hợp
Anonymous: Vô danh
Magnitude: Độ lớn
Abortion: Sự phá thai
Restore: Phục hồi
Whisper: Thì thầm
Plant: Thực vật
Sustain: Duy trì
Duty: Nhiệm vụ
Debate: Tranh luận
Bomb: Bom
Realm: Cảnh giới
Whenever: Bất cứ khi nào
Replace: Thay thế
Theological: Thần học
Ours: Của chúng tôi
Health: Sức khỏe
Request: Yêu cầu
Commissioner: Ủy viên
Mom: Mẹ
Dramatic: Kịch tính
View: Lượt xem
Extension: Sự mở rộng
Husband: Người chồng
Dust: Bụi bặm
Foster: Nuôi dưỡng
Cocaine: Cocaine
Bone: Khúc xương
Bond: Liên kết
Bother: Làm phiền
Disagree: Không đồng ý
Admission: Nhận vào
Van: Van
Moon: Mặt trăng
Rely: Dựa
Ally: Đồng minh
Defendant: Bị cáo
Income: Thu nhập
Internal: Bên trong
Beneath: Ở trên
Boot: Khởi động
Item: Mục
Boom: Sự bùng nổ
Gene: Gen
Mortgage: Thế chấp
Book: Sách
Notion: Khái niệm
Compare: So sánh
Surprising: Thật ngạc nhiên
Identity: Danh tính
Pursue: Theo đuổi
Defend: Phòng thủ
Existence: Sự tồn tại
Campus: Khuôn viên
Officially: Chính thức
Translation: Dịch
Retired: Nghỉ hưu
Happen: Xảy ra
Surprise: Sự ngạc nhiên
Shoe: Giày
Care: Quan tâm
Card: Thẻ
Shop: Cửa tiệm
Tackle: Giải quyết
Mood: Khí sắc
Advantage: Lợi thế
Animal: Thú vật
Acceptable: Chấp nhận được
Ear: Tai
Eat: Ăn
Level: Cấp độ
Show: Chỉ
Guilty: Tội lỗi
Kneel: Quỳ xuống
Shot: Bắn
Those: Những, cái đó
Cast: Dàn diễn viên
Large: Lớn
German: Tiếng đức
Cash: Tiền mặt
Case: Trường hợp
Mrs: Bà
Prison: Nhà tù
More: Hơn
Economy: Nên kinh tê
Mother: Mẹ
Either: Hoặc
Kill: Giết chết
According: Theo
Cart: Xe đẩy
Table: Bàn
Custom: Tập quán
Electronic: Điện tử
Thread: Chủ đề
Celebrate: Ăn mừng
Yard: Sân
Born: Sinh ra
Model: Mô hình
Pocket: Bỏ túi
Recording: Ghi âm
Online: Trực tuyến
Primarily: Chủ yếu
Caught: Bắt
Laundry: Giặt ủi
Rent: Thuê
Threat: Mối đe dọa
Company: Công ty
Disease: Dịch bệnh
Pastor: Mục sư
Venture: Liên doanh
Most: Phần lớn
Mount: Gắn kết
Central: Trung tâm
World: Thế giới
Harvest: Mùa gặt
Investigator: Điều tra viên
Aesthetic: Thẩm mỹ
Boss: Trùm
Excellent: Xuất sắc
King: Nhà vua
Certain: Chắc chắn
Horse: Con ngựa
Kind: Loại
Stream: Suối
Sacred: Linh thiêng
Works: Công trinh
Mud: Bùn
Assembly: Hội,, tổ hợp
Demand: Nhu cầu
Script: Kịch bản
Usually: Thông thường
Character: Tính cách
Streak: Streak
Period: Giai đoạn
Sequence: Trình tự
Operating: Điều hành
Cave: Hang
Senate: Thượng nghị viện
Nuclear: Nguyên tử
Professional: Chuyên nghiệp
Championship: Chức vô địch
Assume: Giả định
Concentrate: Tập trung
Both: Cả hai
Considerable: Đáng kể
Favorite: Yêu thích
Wheel: Bánh xe
Obstacle: Trở ngại
Resort: Phương sách
Variable: Biến
Glory: Vinh quang
Considerably: Đáng kể
Operation: Hoạt động
Reason: Lý do
Segment: Phần
Friendship: Hữu nghị
Rest: Nghỉ ngơi
Credit: Tín dụng
Lobby: Sảnh đợi
Move: Di chuyển
Minority: Thiểu số
Occasional: Thỉnh thoảng
Insect: Côn trùng
Accompany: Đi kèm
Egg: Trứng
Attach: Đính kèm
Pulse: Xung
Attack: Tấn công
Ego: Tự ngã
African: Châu phi
Via: Thông qua
Architect: Kiến trúc sư
Normally: Bình thường
Shut: Đóng lại
Casino: Casino
Luck: May mắn
Signature: Chữ ký
Total: Toàn bộ
Also: Cũng thế
Guilt: Tội lỗi
Privilege: Đặc quyền
Badly: Tệ
Water: Nước
Think: Suy nghĩ
Creature: Sinh vật
Recipe: Công thức
Difficulty: Khó khăn
Steady: Vững chắc
Shove: Xô
Therefore: Vì thế
Powder: Bột
Capable: Có khả năng
Helmet: Mũ bảo hiểm
Proportion: Tỉ lệ
Wildlife: Động vật hoang dã
Outstanding: Nổi bật
Opposed: Phản đối
Bowl: Bát
Portion: Phần
Thing: Điều
Junior: Em
Consider: Xem xét
Audience: Thính giả
Everywhere: Mọi nơi
Highway: Xa lộ
Apparent: Rõ ràng
Confuse: Nhầm lẫn
Exposure: Phơi bày
Impression: Ấn tượng
Orientation: Sự định hướng
Reduce: Giảm
Portray: Miêu tả
Related: Liên quan
Analysis: Phân tích
Technical: Kỹ thuật
Booth: Gian hàng
Numerous: Nhiều
Scared: Sợ hãi
Breathe: Thở
Decade: Thập kỷ
Satellite: Vệ tinh
Ambition: Tham vọng
Diary: Nhật ký
Surface: Bề mặt
Attempt: Cố gắng
Voting: Bầu cử
Boost: Tăng
Watch: Đồng hồ đeo tay
Middleclass: Tầng lớp trung lưu
Workshop: Xưởng
Dirty: Dơ bẩn
Sexually: Tình dục
Faculty: Giảng viên
Social: Xã hội
Crash: Tai nạn
Conservative: Thận trọng
Relationship: Mối quan hệ
Forward: Phía trước
Shout: Kêu la
Combined: Kết hợp
Kiss: Hôn
Quarter: Phần tư
Treasure: Kho báu
Start: Khởi đầu
Apply: Ứng dụng
Regional: Khu vực
Global: Toàn cầu
Jewish: Người do thái
Shore: Bờ biển
Vehicle: Phương tiện
Anyway: Dù sao
Racial: Chủng tộc
Debt: Món nợ
Involve: Liên quan
Placement: Vị trí
Brother: Em trai
Headline: Tiêu đề
Greatly: Rất nhiều
Short: Ngắn
Unless: Trừ khi
Circle: Vòng tròn
Dead: Đã chết
Financial: Tài chính
Psychologist: Nhà tâm lý học
Flour: Bột mì
Irony: Mỉa mai
Deal: Thỏa thuận
European: Châu âu
Enormous: To lớn
About: Khoảng
Heritage: Gia tài
Chemistry: Hóa học
Dear: Kính thưa
Intact: Nguyên vẹn
Spending: Chi tiêu
State: Tiểu bang
Vision: Tầm nhìn
External: Bên ngoài
Bottom: Đáy
End: Kết thúc
Icon: Biểu tượng
Expensive: Đắt
Above: Ở trên
Press: Nhấn
Beard: Râu
Juror: Bồi thẩm đoàn
Supermarket: Siêu thị
Prefer: Thích hơn
Standard: Tiêu chuẩn
Wander: Đi lang thang
Naturally: Một cách tự nhiên
Over: Kết thúc
Oven: Lò nướng
Welfare: Phúc lợi
Virtually: Hầu như
Won't: Sẽ không
Escape: Thoát khỏi
Equate: Cân bằng
Report: Bài báo cáo
Sector: Ngành
Closest: Gần nhất
People: Những người
Unfortunately: Không may
Deck: Boong
Portrait: Chân dung
Accelerate: Đẩy nhanh
Beast: Quái thú
Indicator: Chỉ thị
Allow: Cho phép
Municipal: Thành phố
Apple: Táo
Stare: Nhìn chằm chằm
Dominate: Thống trị
Admit: Thừa nhận
Gasoline: Xăng
Impressive: Ấn tượng
Community: Cộng đồng
Magazine: Tạp chí
Undertake: Thực hiện
Prisoner: Tù nhân
Aunt: Cô dì
Lung: Phổi
License: Giấy phép
Practically: Thực tế
Assignment: Nhiệm vụ
Dense: Dày đặc
Marine: Biển
Restrict: Giới hạn
Excuse: Tha
Fascinating: Hấp dẫn
Agent: Đặc vụ
Everyone: Tất cả mọi người
Violence: Bạo lực
Deem: Thấy
Uncomfortable: Khó chịu
Deep: Sâu
Square: Quảng trường
Arena: Đấu trường
Consensus: Sự đồng thuận
Creativity: Sáng tạo
Deer: Con nai
Essentially: Bản chất
Governor: Thống đốc
Screening: Kiểm tra
Era: Kỷ nguyên
Helpful: Hữu ích
Finally: Cuối cùng
Hide: Ẩn giấu
Meant: แทน เลือก ปัก
Organization: Cơ quan
Pause: Tạm ngừng
American: Người mỹ
Injury: Chấn thương
Clinical: Lâm sàng
Profile: Hồ sơ
Side: Bên
Injure: Làm bị thương
Intelligent: Thông minh
Respondent: Người trả lời
Bacteria: Vi khuẩn
Population: Dân số
Among: Trong số
Joke: Đùa
Dominant: Có ưu thế
Killer: Sát thủ
Judgment: Phán đoán
Quick: Nhanh chóng
Installation: Cài đặt
Solar: Hệ mặt trời
Percentage: Phần trăm
Join: Tham gia
Pursuit: Theo đuổi
Sweater: Áo len
Driveway: Đường lái xe
Etc: Vv
Sick: Đau ốm
Freshman: Sinh viên năm nhất
Net: Mạng lưới
Recession: Suy thoái kinh tế
Galaxy: Thiên hà
New: Mới
Choice: Lựa chọn
Eyebrow: Lông mày
Counter: Quầy tính tiền
Enjoy: Thưởng thức
Third: Thứ ba
Fifth: Thứ năm
Deposit: Tiền gửi
Fifty: Năm mươi
Salmon: Cá hồi
Strongly: Mạnh mẽ
However: Tuy nhiên
Public: Công cộng
Chunk: Mảnh
Conversion: Chuyển đổi
Three: Số ba
Resistance: Sức đề kháng
Changing: Thay đổi
Approach: Tiếp cận
Champion: Quán quân
Colony: Thuộc địa
Library: Thư viện
Artificial: Nhân tạo
Formerly: Trước kia
Nation: Quốc gia
Butterfly: Con bướm
Prohibit: Cấm
Resemble: Giống
Compromise: Thỏa hiệp
Auto: Tự động
Blanket: Cái mền
Cuban: Cuba
Through: Xuyên qua
High: Cao
Tennis: Quần vợt
Craft: Nghề thủ công
Extreme: Cực
Landing: Đổ bộ
Coordinator: Điều phối viên
Sigh: Thở dài
English: Anh
Northwest: Tây bắc
Disappointment: Thất vọng
Sign: Ký tên
Predator: Người ăn thịt
Unprecedented: Chưa từng có
Aircraft: Phi cơ
Quotient: Phép chia
Pilot: Phi công
Aluminum: Nhôm
Deny: Phủ nhận
Demonstrate: Chứng minh
Wound: Vết thương
Direct: Thẳng thắn
Eye: Mắt
Passing: Đi qua
Elder: Đàn anh
Sculpture: Điêu khắc
Married: Cưới nhau
Throw: Ném
Currency: Tiền tệ
Smooth: Trơn tru
Hike: Đi lang thang
Thank: Cảm tạ
Hispanic: Người hispanic
Victim: Nạn nhân
Towel: Khăn tắm
Discourse: Đàm luận
Managing: Quản lý
Molecule: Phân tử
Project: Dự án
Alley: Hẻm
Accident: Tai nạn
Passion: Niềm đam mê
Spoon: Cái thìa
Amazing: Kinh ngạc
Running: Đang chạy
Phenomenon: Hiện tượng
Tower: Tháp
Demonstration: Trình diễn
Laugh: Cười
Carrot: Cà rốt
Hill: Đồi núi
Should: Nên
Whereas: Trong khi
Announcement: Thông báo
Vast: Rộng lớn
Attribute: Thuộc tính
Growth: Sự phát triển
Buyer: Người mua
Identification: Nhận biết
Would: Sẽ
Solid: Chất rắn
Deeply: Sâu sắc
Silk: Lụa
Easily: Dễ dàng
Adult: Người lớn
Substance: Vật chất
Estimated: Ước tính
Guarantee: Bảo hành
Window: Cửa sổ
Really: Có thật không
Express: Bày tỏ
Inherent: Vốn có
Deficit: Thâm hụt
Statement: Tuyên bố
Connection: Kết nối
Religion: Tôn giáo
Disclose: Tiết lộ
Subsequent: Sau đó
Intimate: Thân mật
Occupation: Nghề nghiệp
Entirely: Hoàn toàn
Amid: Giữa
Select: Lựa chọn
Writing: Viết
Dispute: Tranh chấp
Growing: Phát triển
Vary: Thay đổi
Standing: Đứng
Telescope: Kính viễn vọng
Federal: Liên bang
Scheme: Kế hoạch
Tube: Ống
Once: Một lần
Anything: Bất cứ điều gì
Hint: Dấu
Noise: Tiếng ồn
Basement: Tầng hầm
Sing: Hát
Manager: Giám đốc
Subtle: Tế nhị
Divide: Chia
Beach: Bờ biển
Compose: Soạn, biên soạn
Container: Thùng đựng hàng
Supposedly: Được cho là
Partial: Một phần
Sink: Bồn rửa
Confidence: Sự tự tin
Efficiency: Hiệu quả
Desk: Bàn
Outdoor: Ngoài trời
Recall: Hồi tưởng
Carrier: Vận chuyển
Costly: Tốn kém
Species: Loài
Bankruptcy: Phá sản
Heaven: Thiên đường
Nod: Gật đầu
Spoke: Nói
Thought: Nghĩ
Nor: Cũng không
Terrific: Khủng khiếp
Not: Không phải
Tighten: Thắt chặt
Surveillance: Giám sát
Medium: Trung bình
Now: Hiện nay
Enter: Đi vào
Immigration: Nhập cư
Quiet: Yên tĩnh
Specify: Chỉ định
Brown: Nâu
Conspiracy: Âm mưu
Criticize: Chỉ trích
Was: Đã
War: Chiến tranh
Review: Ôn tập
Continue: Tiếp tục
Scandal: Vụ bê bối
Council: Hội đồng
Manner: Cách thức
Way: Đường
Engineer: Kỹ sư
Inflation: Lạm phát
Earthquake: Động đất
Quality: Phẩm chất
Striking: Nổi bật
Overwhelming: Áp đảo
Finger: Ngón tay
Productive: Có năng suất
What your name ?: May ten la gi ?
Tuck: Tuck
Regardless: Bất kể
Episode: Tập phim
Liquid: Chất lỏng
Continent: Lục địa
Fan: Quạt
Wooden: Bằng gỗ
Equipment: Trang thiết bị
Far: Xa
Lightning: Sét đánh
Clothes: Quần áo
Fat: Mập
Regulation: Quy định
Meaning: Ý nghĩa
Gradually: Dần dần
Leadership: Khả năng lãnh đạo
Usual: Thường lệ
Triangle: Tam giác
Cartoon: Hoạt hình
Density: Tỉ trọng
Dessert: Món tráng miệng
Negotiate: Đàm phán
Bless: Ban phước
Goal: Mục tiêu
Bottle: Chai
Equal: Công bằng
Pistol: Súng lục
Development: Phát triển
Special: Đặc biệt
Bloody: Dính máu
Goat: Con dê
Planet: Hành tinh
Excitement: Sự phấn khích
Women: Đàn bà
Added: Thêm
Afternoon: Buổi chiều
Emphasis: Nhấn mạnh
Valuable: Quý giá
Curve: Đường cong
Suburban: Ngoại ô
House: Nhà ở
Passage: Đoạn văn
Breeze: Khoe khoang
Commonly: Thông thường
Terror: Khủng bố
Practitioner: Học viên
Idea: Ý kiến
Institutional: Thể chế
Plead: Biện hộ
Web: Web
Hire: Thuê mướn
Crime: Tội ác
Country: Quốc gia
Conscience: Lương tâm
Performance: Hiệu suất
Current: Hiện hành
Belong: Thuộc về
Site: Địa điểm
Meaningful: Có ý nghĩa
Lover: Người yêu
Opinion: Quan điểm
Visitor: Khách thăm quan
Article: Bài báo
Conservation: Bảo tồn
Diversity: Sự đa dạng
Glass: Ly
Wet: Ướt
Plastic: Nhựa
Coffee: Cà phê
Suggest: Đề nghị
Being: Đang
Assumption: Giả thiết
Soldier: Lính
Exceed: Quá
Fundamental: Căn bản
Outfit: Trang phục
Monster: Quái vật
Lead: Chì
Habitat: Môi trường sống
Leaf: Lá
Almost: Hầu hết
Fixed: Đã sửa
Guitar: Đàn ghi ta
Road: Đường
Fee: Chi phí
Nut: Hạt
Artifact: Đồ tạo tác
Corporation: Tập đoàn
Sack: Bao
Silence: Khoảng lặng
Puzzle: Câu đố
Few: Vài
Impress: Gây ấn tượng
Quite: Khá
Facility: Cơ sở
Earnings: Thu nhập
Variation: Biến thể
Raise: Nâng cao
Classify: Phân loại
Safe: An toàn
Update: Cập nhật
Mixture: Hỗn hợp
Formula: Công thức
Sport: Môn thể thao
Forever: Mãi mãi
Technology: Công nghệ
Production: Sản xuất
Ugly: Xấu xí
Emerging: Mới nổi
Patent: Bằng sáng chế
Hospital: Bệnh viện
Woman: Đàn bà
Tightly: Chặt chẽ
Who: Người nào
Order: Gọi món
Struggle: Đấu tranh
Lean: Nạc
Rock: Đá
Device: Thiết bị
Especially: Đặc biệt
Why: Tại sao
Convey: Chuyên chở
Leap: Nhảy vọt
Flag: Cờ
Catalog: Mục lục
Charter: Điều lệ
Weak: Yếu
Profession: Chuyên nghiệp
Entire: Toàn bộ
Atmosphere: Không khí
Wear: Mặc
Combat: Chống lại
Flat: Bằng phẳng
Closely: Chặt chẽ
Win: Thắng lợi
Northeast: Đông bắc
Divine: Thần thánh
Exhibit: Triển lãm
Forget: Quên
Basket: Cái rổ
Appropriate: Thích hợp
Carbohydrate: Carbohydrate
Healthy: Khỏe mạnh
Blend: Trộn
Fig: Sung
Only: Chỉ có
Silent: Im lặng
Fit: Phù hợp
Temporary: Tạm thời
Fix: Sửa chữa
Fight: Chiến đấu
Minor: Diễn viên phụ
Historical: Lịch sử
Dealer: Người buôn bán
Left: Trái
Girlfriend: Bạn gái
Ideal: Lý tưởng
Produce: Sản xuất
Size: Kích thước
Legislature: Cơ quan lập pháp
Product: Sản phẩm
Weapon: Vũ khí
Stiff: Cứng
Design: Thiết kế
Dream: Mơ tưởng
Decimal: Thập phân
National: Quốc gia
Picture: Hình ảnh
Diagnosis: Chẩn đoán
Expansion: Sự bành trướng
Straighten: Làm thẳng
Hair: Tóc
Personal: Cá nhân
Weed: Cỏ dại
Flee: Chạy trốn
Confess: Xưng
Method: Phương pháp
Eligible: Hội đủ điều kiện
Olympic: Olympic
Said: Nói
Sail: Cánh buồm
Crease: Nếp gấp
Colleague: Đồng nghiệp
Political: Chính trị
Fabric: Vải
Week: Tuần
Tune: Điều chỉnh
Grocery: Tạp hóa
Sale: Buôn bán
Cargo: Hàng hóa
Correlation: Tương quan
Somewhat: Phần nào
Grain: Ngũ cốc
Timber: Gỗ
Infant: Trẻ sơ sinh
Labor: Lao động
Rebuild: Xây dựng lại
Salt: Muối
Fly: Bay
Propose: Cầu hôn
Enforce: Thi hành
Apology: Xin lỗi
Herself: Cô ấy
Shortterm: Thời gian ngắn
Bounce: Tung lên
Ensure: Đảm bảo
Indicate: Biểu thị
Mysterious: Huyền bí
Pick: Chọn
Accent: Giọng điệu
Casual: Giản dị
Familiar: Quen
Rapid: Nhanh
Sake: Lợi ích
Ankle: Mắt cá
Extraordinary: Bất thường
Medicine: Dược phẩm
Half: Một nửa
Validity: Hiệu lực
Curiosity: Sự tò mò
Dough: Bột
Entrepreneur: Doanh nhân
Hall: Đại sảnh
Wow: Wow
Revolution: Cuộc cách mạng
Sand: Cát
Explanation: Giải trình
Regular: Đều đặn
Radiation: Sự bức xạ
Literally: Nghĩa đen
Facilitate: Tạo điều kiện
Statute: Đạo luật
Humanity: Nhân loại
Nevertheless: Tuy nhiên
Procedure: Thủ tục
Course: Khóa học
Gone: Không còn
Fog: Sương mù
Onto: Trên
Ordinary: Bình thường
Absolutely: Chắc chắn rồi
Gold: Vàng
Same: Tương tự
Golf: Golf
Orbit: Quỹ đạo
Slowly: Chậm rãi
For: Cho
Ritual: Lễ nghi
Pretend: Giả vờ
Flip: Lật
Occasionally: Thỉnh thoảng
Hand: Tay
Gather: Tụ họp
Weight: Cân nặng
Hang: Treo
Role: Vai trò
Economist: Nhà kinh tế học
Rarely: Ít khi
Elephant: Con voi
Stick: Gậy
Oak: Cây sồi
Turn: Xoay
Commitment: Cam kết
Roll: Cuộn
Discussion: Thảo luận
Patch: Vá
Developmental: Phát triển
Measurement: Phép đo
Testimony: Lời khai
Tradition: Truyền thống
Well: Tốt
Barrier: Rào chắn
Outer: Bên ngoài
Field: Cánh đồng
Money: Tiền bạc
Roof: Mái nhà
School: Trường học
Language: Ngôn ngữ
Deadly: Chết người
Generally: Nói chung là
Prepare: Chuẩn bị
Elsewhere: Ở nơi khác
Room: Phòng
International: Quốc tế
Knock: Đánh
Grant: Ban cho
Speed: Tốc độ
Mexican: Mexico
Broker: Người môi giới
Anticipate: Đoán trước
Convinced: Thuyết phục
Coverage: Phủ sóng
Soviet: Liên xô
Football: Bóng đá
Broken: Bị hỏng
Grand: Lớn
Oversee: Giám sát
Secure: Đảm bảo
Delivery: Chuyển
Dying: Chết
Good: Tốt
Chest: Ngực
Respect: Sự tôn trọng
Thinking: Suy nghĩ
Access: Truy cập
Communicate: Giao tiếp
Developer: Nhà phát triển
Juice: Nước ép
Institution: Tổ chức
Potential: Tiềm năng
Remove: Tẩy
Aspect: Khía cạnh
Different: Khác nhau
Doubt: Nghi ngờ
Odd: Lẻ
Establish: Thành lập
Utility: Tiện ích
Expense: Chi phí
Retreat: Rút lui
Determine: Mục đích
Went: Đã đi
Theoretical: Lý thuyết
Human: Nhân loại
Root: Nguồn gốc
Citizenship: Quyền công dân
Hard: Cứng
Lend: Cho vay
Conscious: Có ý thức
Contrast: Tương phản
Japanese: Tiếng nhật
Functional: Chức năng
Rope: Dây thừng
Grape: Giống nho
Harm: Làm hại
Cottage: Nhà tranh
Lens: Ống kính
Advanced: Nâng cao
Complete: Hoàn thành
Transmission: Truyền tải
Persian: Người ba tư
Practice: Thực hành
Right: Đúng
Reader: Người đọc
Rose: Bông hồng
Specialize: Chuyên môn hóa
Off: Tắt
Still: Vẫn
Obvious: Hiển nhiên
Haul: Lôi
Appoint: Bổ nhiệm
Ancient: Xưa
Cling: Bám lấy
Final: Sau cùng
Fun: Vui vẻ
Peanut: Đậu phụng
Fur: Lông thú
Myth: Huyền thoại
Survivor: Người sống sót
Hate: Ghét bỏ
Mobile: Di động
Whole: Toàn thể
Flow: Lưu lượng
Habit: Thói quen
Slave: Nô lệ
Approximately: Xấp xỉ
Climb: Leo
Pile: Đóng cọc
Pill: Viên thuốc
Racism: Chủ nghĩa phân biệt chủng tộc
Latter: Sau này
Obviously: Chắc chắn
Themselves: Bản thân họ
Were: Là
Disturbing: Phiền
Grass: Cỏ
Grasp: Sự hiểu biết
Upstairs: Tầng trên
Punch: Đấm
Coast: Bờ biển
Patience: Kiên nhẫn
Frequently: Thường xuyên
Build: Xây dựng
Ecosystem: Hệ sinh thái
Primary: Sơ cấp
Less: Ít hơn
Sentence: Kết án
Elaborate: Kỹ lưỡng
Somewhere: Một vài nơi
Accept: Chấp nhận
Between: Giữa
Discovery: Khám phá
Trend: Khuynh hướng
Have: Có
Utilize: Sử dụng
Gentleman: Quý ông
Progressive: Cấp tiến
Oil: Dầu
Pink: Hồng
Pine: Cây thông
Fantasy: Tưởng tượng
Save: Tiết kiệm
Breathing: Thở
Hotel: Khách sạn
Congress: Hội nghị
Graduation: Tốt nghiệp
Integrate: Tích hợp
Telephone: Điện thoại
Symbol: Ký hiệu
Makeup: Trang điểm
Remote: Xa
Premise: Tiền đề
Spell: Đánh vần
Marketing: Tiếp thị
Dynamics: Động lực học
Create: Tạo nên
Northern: Phương bắc
Sister: Em gái
Closer: Gần hơn
Integration: Hội nhập
Closet: Tủ quần áo
Teaspoon: Muỗng cà phê
West: Hướng tây
Criticism: Sự chỉ trích
Nowhere: Hư không
Pipe: Ống
Scramble: Tranh giành
Homeless: Vô gia cư
Independent: Độc lập
Upon: Trên
Closed: Đóng
Fuel: Nhiên liệu
Grave: Phần mộ
Spend: Tiêu
Forest: Rừng
Youngster: Thiếu niên
Pray: Cầu nguyện
Sanction (pl): Sự trừng phạt (pl)
Voice: Tiếng nói
Competitor: Đối thủ
Origin: Gốc
Teenager: Thiếu niên
Each: Mỗi
Overall: Tổng thể
Old: Cũ
Previously: Trước đây
Specialist: Chuyên gia
Staff: Cán bộ
United: United
Activity: Hoạt động
Reluctant: Lưỡng lự
Premium: Phí bảo hiểm
Handful: Ít
Waste: Chất thải
Blood: Máu
Imply: Ngụ ý
Month: Tháng
Department: Bộ phận
Develop: Phát triển, xây dựng
Behave: Hành xử
Unknown: Không xác định
Pace: Tốc độ
Permission: Sự cho phép
Unexpected: Bất ngờ
Stage: Sân khấu
Highly: Cao
Pack: Đóng gói
Cliff: Vách đá
Construction: Xây dựng
Banker: Chủ ngân hàng
Background: Lý lịch
Consecutive: Liên tiếp
Murder: Giết người
Activist: Nhà hoạt động
Winner: Người chiến thắng
Later: Một lát sau
Strip: Dải
Float: Phao
Emphasize: Nhấn mạnh
Ecological: Sinh thái
Expand: Mở rộng
Sexuality: Tình dục
Starting: Bắt đầu
Mmhmm: Mm-hmm
Subtract: Trừ đi
Attorney: Luật sư
Shock: Sốc
Fighting: Trận đánh
Immigrant: Di trú
Leader: Lãnh đạo
One: Một
Adequate: Đầy đủ
Advocate: Biện hộ
Quit: Thoái lui
Surprised: Ngạc nhiên
Provide: Cung cấp
Generate: Tạo ra
Nomination: Đề cử
Under: Dưới
Counsel: Lời khuyên
Team: Đội
Nightmare: Ác mộng
Hurricane: Bão
Context: Bối cảnh
Don't: Không
Stroke: Cú đánh
Precious: Quí
Cousin: Anh chị em họ
Inquiry: Yêu cầu
Wealthy: Giàu có
Decision: Phán quyết
Blond: Tóc vàng
Effective: Có hiệu lực
Eighth: Thứ tám
Dock: Bến tàu
Pioneer: Người tiên phong
Drunk: Say
After: Sau
Consistent: Thích hợp
Frequency: Tần số
Traditional: Truyên thông
Pitcher: Người bình
Display: Trưng bày
Nurse: Y tá
Therapy: Trị liệu
Journalist: Nhà báo
Effort: Cố gắng
Click: Nhấp chuột
Page: Trang
Whose: Có
Operate: Vận hành
Partially: Một phần
Strong: Mạnh
Full: Đầy
Learning: Học tập
Native: Tự nhiên
Elect: Trúng tuyển
Potato: Khoai tây
Opt: Opt
Weekly: Hàng tuần
Journalism: Báo chí
Ability: Có khả năng
Clay: Đất sét
Organism: Cơ thể
Tear: Nước mắt
Canvas: Tranh sơn dầu
Inspection: Kiểm tra
Pleasure: Vui lòng
Consequence: Hậu quả
Voluntary: Tình nguyện
Suffer: Đau khổ
Stack: Cây rơm
Specialty: Chuyên môn
Delight: Hân hoan
Kitchen: Phòng bếp
Onethird: Một phần ba
Gap: Lỗ hổng
Photographer: Nhiếp ảnh gia
Gas: Khí đốt
Latin: Latin
Does: Làm
Border: Biên giới
Enthusiasm: Hăng hái
Gay: Gay
Willingness: Sự sẵn lòng
Separate: Tách rời
Relax: Thư giãn
Fund: Quỹ
Bias: Sự thiên vị
Cheek: Má
Twentieth: Hai mươi
Transportation: Vận chuyển
Element: Thành phần
Legal: Hợp pháp
Corridor: Hành lang
Equity: Công bằng
Shadow: Bóng
Heavily: Nặng nề
Stupid: Ngốc nghếch
Cheer: Vui lên
Straw: Rơm rạ
Superior: Cấp trên
Vessel: Tàu
Aside: Qua một bên
Documentary: Phim tài liệu
Empty: Trống
Pain: Đau đớn
Presence: Sự hiện diện
Stumble: Tình cờ gặp
Teen: Thiếu niên
Pair: Đôi
Concerning: Có liên quan
Desire: Khao khát
Midst: Giữa
Charge: Sạc điện
Depression: Phiền muộn
Patient: Bệnh nhân
Title: Chức vụ
Accommodate: Chứa
Someone: Người nào
Humor: Hài hước
Speculation: Suy đoán
Pound: Pao
Contribute: Góp phần
Editor: Người biên tập
Location: Vị trí
Migration: Di cư
Satisfaction: Sự thỏa mãn
Check: Kiểm tra
Programming: Lập trình
Trainer: Người huấn luyện
Asian: Châu á
Away: Xa
Grandfather: Ông nội
Contest: Cuộc thi
Continued: Tiếp tục
Resign: Từ chức
Upset: Buồn bã
Thigh: Đùi
Faster: Nhanh hơn
Longtime: Thời gian dài
Captain: Đội trưởng
Counterpart: Đối tác
Our: Của chúng ta
Out: Ngoài
Smell: Mùi
Letter: Lá thư
Adjust: Điều chỉnh
Suffix: Hậu tố
Turkey: Gà tây
Switch: Công tắc điện
Get: Được
Society: Xã hội
Contract: Hợp đồng
Shoot: Bắn
Opera: Opera
Oppose: Phản đối
Legend: Huyền thoại
Description: Sự miêu tả
Genetic: Di truyền
Doll: Búp bê
Challenge: Thử thách
Cheap: Giá rẻ
Sense: Giác quan
Clip: Kẹp
Criminal: Phạm tội
Cheat: Lừa đảo
Dilemma: Tình trạng khó xử
Visible: Có thể nhìn thấy
Mystery: Huyền bí
Owe: Nợ
Retirement: Nghỉ hưu
Killing: Giết chết
Pattern: Mẫu
Stance: Lập trường
Fashion: Thời trang
Own: Sở hữu
Following: Tiếp theo
Rolling: Lăn
Guideline: Hướng dẫn
Depressed: Suy sụp
Promote: Quảng bá
Pencil: Bút chì
Praise: Ca ngợi
Housing: Nhà ở
Tribal: Bộ lạc
Lunch: Bữa trưa
Pale: Nhợt nhạt
Stand: Đứng
Teammate: Đồng đội
Ladder: Thang
Known: Nổi tiếng
Palm: Lòng bàn tay
Sunlight: Ánh sáng mặt trời
Photograph: Ảnh chụp
Done: Làm xong
Night: Đêm
Extremely: Vô cùng
Builder: Người xây dựng
Toilet: Phòng vệ sinh
Affect: Có ảnh hưởng đến
Recovery: Phục hồi
Arrive: Đến nơi
Bubble: Bong bóng
Wisdom: Sự khôn ngoan
Organize: Tổ chức
Crazy: Khùng
Narrative: Tường thuật
Conclude: Kết luận
Strategic: Chiến lược
Spanish: Người tây ban nha
Advertising: Quảng cáo
Practical: Thiết thực
Stake: Cổ phần
Coach: Huấn luyện viên
Contend: Đấu tranh
Apparently: Dường như
Characteristic: Đặc trưng
Effectively: Có hiệu quả
Marble: Đá hoa
Thick: Dày
Furthermore: Hơn nữa
Extend: Mở rộng
Content: Nội dung
Pitch: Sân cỏ
Block: Khối
Concrete: Bê tông
Software: Phần mềm
Whoever: Bất cứ ai
Garbage: Rác thải
Vulnerable: Dễ bị tổn thương
Extent: Phạm vi
Flood: Lũ
Feedback: Phản hồi
Destroy: Hủy hoại
Thanks: Cảm ơn
Earn: Kiếm
Deliberately: Thong thả
Floor: Sàn nhà
Crawl: Thu thập thông tin
Secondary: Thứ hai
Technician: Kỹ thuật viên
Finance: Tài chính
Zone: Vùng
Door: Cửa
Stair: Cầu thang
Response: Phản ứng
Serious: Nghiêm trọng
Additional: Bổ sung
Tell: Nói
Informal: Không chính thức
Tshirt: Áo thun
Officer: Nhân viên văn phòng
Devastating: Tàn phá
Silly: Ngớ ngẩn
Easy: Dễ dàng
Identical: Giống nhau
Genuine: Chính hãng
Good (pl): Tốt (pl)
String: Chuỗi
Summit: Hội nghị thượng đỉnh
Mild: Nhẹ nhàng
Particle: Hạt
Mile: Dặm
Suggestion: Gợi ý
Cabin: Cabin
Pass: Vượt qua
Past: Quá khứ
Mill: Cối xay
Greatest: Vĩ đại nhất
Might: Có thể
Anxiety: Sự lo ngại
Harassment: Quấy rối
Dose: Liều
Bike: Xe đạp
Milk: Sữa
Tend: Có xu hướng
Maybe: Có lẽ
Alternative: Thay thế
Acquisition: Mua lại
Cultural: Văn hoá
Ease: Giảm bớt
Likely: Có khả năng
Crisis: Khủng hoảng
Park: Công viên
Tent: Lều
Newspaper: Báo chí
Islam: Đạo hồi
Part: Phần
Someday: Một ngày nào đó
Bill: Hóa đơn
Author: Tác giả
Planning: Lập kế hoạch
East: Đông
Itself: Chinh no
Building: Tòa nhà
Bind: Trói buộc
Accounting: Kế toán
Definitely: Chắc chắn
Similarly: Tương tự
Beyond: Vượt ra ngoài
Inch: Inch
Personnel: Nhân viên
Adopt: Thông qua
French: Người pháp
Shortage: Sự thiếu
Mind: Lí trí
Playoff: Playoff
Mine: Tôi
Comply: Tuân theo
Evolution: Sự phát triển
Controversy: Tranh cãi
God: Thần
Openly: Cởi mở
Honor: Tôn vinh
Path: Con đường
Minimize: Giảm thiểu
Belly: Bụng
Parking: Bãi đỗ xe
Personality: Nhân cách
Century: Thế kỷ
Got: Có
Chairman: Chủ tịch
Competitive: Cạnh tranh
Pad: Tập giấy
Submit: Đệ trình
Assign: Chỉ định
Apart: Xa nhau
Expectation: Sự mong đợi
Pan: Chảo
Initial: Ban đầu
Explo de: Nổ tung
Participation: Sự tham gia
Pat: Vỗ vỗ
Email: E-mail
Russian: Người nga
Legacy: Di sản
Liver: Gan
Pay: Trả
Stereotype: Khuôn mẫu
Tourist: Du lịch
Educator: Nhà giáo dục
Founder: Người sáng lập
Servant: Người hầu
Argue: Tranh luận
Tourism: Du lịch
Winter: Mùa đông
Test: Thử nghiệm
Camera: Máy ảnh
Southern: Phía nam
Shift: Sự thay đổi
Prediction: Dự đoán
Representation: Đại diện
Twelve: Mười hai
Term: Kỳ hạn
Physically: Thể chất
Fiscal: Tài chính
Brand: Nhãn hiệu
Walking: Đi dạo
Compel: Bắt buộc
Adolescent: Thanh niên
Gallery: Bộ sưu tập
Isolate: Cô lập
Softly: Nhẹ nhàng
Bridge: Cầu
Philosophy: Triết học
Bird: Chim
Consistently: Nhất quán
Republic: Nước cộng hòa
Offender: Tội phạm
Urban: Đô thị
Presumably: Có lẽ
Refer: Tham khảo
Forth: Ra
Opportunity: Cơ hội
C rack: Bẻ khóa
Classroom: Phòng học
Evidence: Chứng cớ
Autonomy: Tự trị
Brake: Phanh
Component: Thành phần
Attendance: Sự tham dự
Forty: Bốn mươi
Down: Xuống
Adventure: Cuộc phiêu lưu
Return: Trở về
Pickup: Nhặt lên
Baby: Đứa bé
Freely: Tự do
Airplane: Máy bay
White: Trắng
Feminist: Nữ quyền sĩ
Rental: Thuê
Exactly: Chính xác
Imagination: Trí tưởng tượng
Club: Câu lạc bộ
Pen: Cây bút
Clue: Manh mối
Associate: Liên kết
Per: Mỗi
Pet: Vật nuôi
Violation: Sự vi phạm
Brain: Óc
Bite: Cắn
Ambassador: Đại sứ
Businessman: Doanh nhân
Forum: Diễn đàn
Made: Thực hiện
Shirt: Áo sơ mi
Back: Trở lại
Witness: Nhân chứng
Asset: Tài sản
Stuff: Đồ đạc
Minister: Bộ trưởng, mục sư
Gun: Súng
League: Liên đoàn
Load: Tải trọng
Catholic: Công giáo
Enhance: Nâng cao
Ambitious: Đầy tham vọng
Gut: Ruột
Guy: Chàng
Credibility: Uy tín
Loan: Tiền vay
Blessing: Phước lành
Convict: Tù nhân
Miss: Bỏ lỡ
Gathering: Thu thập
Technique: Kỹ thuật
Faint: Mờ nhạt
Fiction: Viễn tưởng
Margin: Lề
Justice: Sự công bằng
Darkness: Bóng tối
Oldfashioned: Cổ hủ
Meeting: Gặp gỡ
Longterm: Dài hạn
Direction: Phương hướng
Depth: Chiều sâu
Experienced: Có kinh nghiệm
Former: Trước đây
Outlet: Đầu ra
Slightly: Khinh bỉ
Myself: Riêng tôi
Study: Học
Believe: Tin
Movement: Phong trào
Cabinet: Buồng
Popularity: Phổ biến
Text: Bản văn
Indeed: Thật
Appearance: Xuất hiện
Pie: Chiếc bánh
Defense: Phòng thủ
Honestly: Thành thật
Pig: Con lợn
Lock: Khóa
Clinic: Phòng khám bệnh
Fear: Nỗi sợ
Wrong: Sai rồi
Wedding: Lễ cưới
Pin: Ghim
Rumor: Tin đồn
Transition: Quá trình chuyển đổi
Legislative: Lập pháp
Pit: Hố
Tendency: Khuynh hướng
Including: Kể cả
Powerful: Quyền lực
Mayor: Thị trưởng
Benefit: Lợi ích
Electronics: Thiết bị điện tử
Contemplate: Thưởng ngoạn
Shine: Tỏa sáng
Tomato: Cà chua
Factor: Hệ số
Gym: Phòng thể dục
Impossible: Không thể nào
Invisible: Vô hình
Soften: Làm mềm
Feed: Nuôi
Occupy: Chiếm
Verdict: Bản án
Explosion: Nổ
Vacation: Kỳ nghỉ
Weigh: Cân
Guest: Khách
Guess: Phỏng đoán
Fatigue: Mệt mỏi
Recipient: Người nhận
Unlikely: Không chắc
Strain: Sự căng thẳng, quá tải
Exhaust: Thoát ra
Painful: Đau đớn
Transaction: Giao dịch
Resist: Kháng cự
Skip: Bỏ qua
Option: Tùy chọn
Skin: Da
Spectacular: Đẹp mắt
Runner: Người chạy
Dynamic: Năng động
Remarkable: Đáng chú ý
Visit: Chuyến thăm
Formal: Chính thức
Accuracy: Tính chính xác
Format: Định dạng
Monitor: Giám sát
Lighting: Thắp sáng
Bedroom: Phòng ngủ
Eliminate: Loại bỏ
Safety: An toàn
Topic: Đề tài
Sugar: Đường
Gravity: Nghiêm trọng
Collapse: Sự sụp đổ
Pregnant: Có thai
Widow: Người đàn bà góa
Hunting: Săn bắn
Dress: Trang phục
Bake: Bake
Feel: Cảm thấy
Invade: Xâm chiếm
Faith: Đức tin
Frontier: Biên giới
Feet: Đôi chân
Forgive: Tha lỗi
Grandchild: Cháu ngoại
Series: Loạt
Garage: Gara
Mail: Thư
Whale: Cá voi
Religious: Tôn giáo
Representative: Tiêu biểu
Desert: Sa mạc
Main: Chủ yếu
Invite: Mời gọi
Ball: Trái bóng
Numeral: Số
Obligation: Nghĩa vụ
Ground: Đất
Sweep: Quét
Psychology: Tâm lý học
Spiritual: Tinh thần
Male: Nam giới
Burden: Gánh nặng
Feature: Đặc tính
Inner: Bên trong
Mall: Trung tâm mua sắm
Administrator: Người quản lý
Follow: Theo
Instructional: Hướng dẫn
Actor: Diễn viên
Least: Ít nhất
Sweet: Ngọt
Foundation: Nền tảng
Repair: Sửa
Loose: Lỏng lẻo
Courtroom: Phòng xử án
Trial: Thử nghiệm
Shake: Lắc
Unusual: Bất thường
Make: Chế tạo
Principle: Nguyên tắc
Spring: Mùa xuân
Handle: Xử lý
Pop: Nhạc pop
Written: Bằng văn bản
Pot: Nồi
Basically: Về cơ bản
Melody: Giai điệu êm ái
Philosophical: Triết học
Proclaim: Tuyên bố
Charity: Từ thiện
Recognition: Sự công nhận
Bank: Ngân hàng
Processor: Bộ vi xử lý
Asleep: Ngủ
Indication: Dấu hiệu
Traffic: Giao thông
Band: Ban nhạc
Envelope: Phong bì
Natural: Tự nhiên
Certainly: Chắc chắn
Often: Thường xuyên
Open: Mở
Association: Hiệp hội
Weird: Kỳ dị
Star: Ngôi sao
Peasant: Nông dân
Female: Giống cái
Emotion: Cảm xúc
Many: Nhiều
Wolf: Chó sói
Protocol: Giao thức
Stay: Ở lại
Describe: Miêu tả
Cure: Chữa khỏi
Immune: Miễn dịch
Had: Đã có
Cholesterol: Cholesterol
Fever: Sốt
Pretty: Đẹp
Great: Tuyệt quá
Several: Một số
Violate: Xâm phạm
Sleep: Ngủ
Treaty: Hiệp ước
Choose: Chọn
Music: Âm nhạc
Investigation: Cuộc điều tra
Hat: Nón
Learn: Học hỏi
Recognize: Nhìn nhận
Has: Có
Congressional: Quốc hội
Compliance: Sự tuân thủ
Constraint: Hạn chế
Felt: Cảm thấy
Explicit: Rõ ràng
Pro: Pro
Backyard: Sân sau
Look: Nhìn
Swear: Xin thề
Sweat: Mồ hôi
Analyze: Phân tích
Respectively: Tương ứng
Annually: Hàng năm
Expected: Kỳ vọng
Into: Vào
Cute: Dễ thương
Bring: Mang đến
Continuing: Tiếp tục
Irish: Người ailen
Convenience: Tiện
Ideological: Ý thức hệ
Efficient: Hiệu quả
Long: Dài
Class: Lớp học
Scan: Quét
Wrote: Đã viết
Medal: Huy chương
Domain: Miền
Carve: Khắc chạm
Fell: Rơi
Judge: Thẩm phán
Lone: Đơn độc
Crystal: Pha lê
Warehouse: Kho
Christmas: Giáng sinh
Maintain: Duy trì
Barn: Chuồng trại
Parent: Cha mẹ
Yes: Vâng
Vitamin: Vitamin
Contributor: Người đóng góp
Leave: Rời khỏi
Mark: Dấu
Yet: Chưa
Delicate: Tinh tế
Step: Bậc thang
Conduct: Hạnh kiểm
Bare: Trần
Nationwide: Toàn quốc
Stem: Thân cây
Detailed: Chi tiết
Justify: Biện hộ
Shade: Bóng râm
Ethics: Đạo đức
Safely: An toàn
Opening: Khai mạc
Burst: Nổ
Shopping: Mua sắm
Devote: Cống hiến
Loop: Vòng lặp
Attraction: Sức hút
Substantial: Đáng kể
Wood: Gỗ
Tolerance: Lòng khoan dung
Exploration: Thăm dò
Momentum: Đà
Mandate: Ủy nhiệm
Election: Cuộc bầu cử
Interested: Quan tâm
Base: Căn cứ
Put: Đặt
Exhibition: Triển lãm
Guidance: Hướng dẫn
Stranger: Lạ
Lifetime: Cả đời
Greet: Chào hỏi
Her: Cô ấy
Satisfy: Làm vui lòng
Greek: Người hy lạp
Hey: Chào
Green: Màu xanh lá
Strength: Sức mạnh
Prayer: Cầu nguyện
Mate: Người bạn đời
Vital: Quan trọng
Word: Từ
Commander: Chỉ huy
Shark: Cá mập
Celebration: Lễ kỷ niệm
Sharp: Nhọn
Manual: Sổ tay
Bath: Bồn tắm
Math: Môn toán
Thanksgiving: Lễ tạ ơn
Capture: Nắm bắt
Illustrate: Minh họa
Lose: Thua
Database: Cơ sở dữ liệu
Work: Công việc
Shower: Vòi hoa sen
Sacrifice: Sự hy sinh
Examine: Xem xét
Stimulate: Kích thích
Flame: Ngọn lửa
Stability: Sự ổn định
Estate: Bất động sản
Carry: Mang
Mask: Mặt nạ
Apartment: Căn hộ, chung cư
Flavor: Hương vị
Shrug: Nhún vai
Dramatically: Đột ngột
Interrupt: Làm gián đoạn
Twin: Đôi
Mass: Khối lượng
Valid: Có hiệu lực
Inevitable: Chắc chắn xảy ra
Depend: Tùy theo
Inevitably: Chắc chắn
Shape: Hình dạng
Lots: Rất nhiều
Couple: Vợ chồng
Criteria: Tiêu chuẩn
Absolute: Tuyệt đối
Promotion: Quảng cáo
Stir: Khuấy
Hunger: Đói
Minute: Phút
Loud: To tiếng
Encounter: Gặp gỡ
Ratio: Tỉ lệ
Perceived: Lĩnh hội
Logic: Logic
Rubber: Cao su
Examination: Kiểm tra
Freeze: Đông cứng
Lost: Mất đi
Ought: Nên
Associated: Liên kết
Loss: Mất mát
Chapter: Chương
Swell: Sưng lên
Legally: Hợp pháp
Moral: Đạo đức
Dimension: Kích thước
Refuge: Nơi ẩn náu
Disorder: Rối loạn
Him: Anh ta
Hip: Hông
Hit: Đánh
His: Của anh ấy
Preparation: Chuẩn bị
Newly: Mới
Family: Gia đình
Dancing: Khiêu vũ
Share: Chia sẻ
Principal: Hiệu trưởng
Competition: Cuộc thi
Possess: Sở hữu
Beautiful: Đẹp
Include: Bao gồm
Brief: Ngắn gọn
Knowledge: Hiểu biết
Plaintiff: Nguyên đơn
Maximum: Tối đa
Exercise: Tập thể dục
Super: Siêu
Mission: Sứ mệnh
Belief: Niềm tin
Yesterday: Hôm qua
Channel: Kênh
Media: Phương tiện truyền thông
Infection: Nhiễm trùng
Missing: Mất tích
Producer: Nhà sản xuất
Love: Yêu
Become: Trở nên
Fully: Đầy đủ
Headache: Đau đầu
Temperature: Nhiệt độ
Execute: Thi hành
Athlete: Lực sĩ
Shall: Sẽ
Analyst: Nhà phân tích
Designer: Nhà thiết kế
Threaten: Hăm dọa
Danger: Nguy hiểm
Tribe: Bộ lạc
Flash: Đèn flash
Discipline: Kỷ luật
Release: Giải phóng
Risky: Rủi ro
Accurate: Chính xác
Flower: Hoa
Shame: Xấu hổ
Trick: Lừa
Diminish: Suy giảm
Electric: Điện
Surrounding: Xung quanh
Vaccine: Vắc-xin
Bride: Cô dâu
Naked: Trần truồng
Commercial: Thương mại
Missile: Tên lửa
Brick: Gạch
Assist: Hỗ trợ
Nasty: Bẩn thỉu
Original: Nguyên
Claim: Yêu cầu
You: Bạn
Plunge: Lao xuống
Singer: Ca sĩ
Similarity: Sự giống nhau
Pepper: Tiêu
Stop: Dừng lại
Render: Render
Interior: Nội địa
Black: Đen
Conceive: Thụ thai
Equip: Trang bị
Define: Định nghĩa
Excite: Kích thích
Relative: Quan hệ
Harmony: Hòa hợp
Anniversary: Ngày kỷ niệm
Sound: Âm thanh
Anyone: Bất kỳ ai
Blade: Lưỡi
Hot: Nóng bức
Joint: Chung
Hightech: Công nghệ cao
Jurisdiction: Quyền hạn
How: Làm sao
Flexible: Linh hoạt
Museum: Viện bảo tàng
Chamber: Buồng
Sunny: Nắng
Slam: Sập
Instance: Ví dụ
Nearby: Gần đó
Presidential: Tổng thống
Slap: Tát
Entry: Nhập cảnh
Sales: Bán hàng
Critic: Nhà phê bình
Fierce: Khốc liệt
Neck: Cái cổ
Selected: Đã chọn
Essay: Tiểu luận
Speaker: Loa
Liberal: Tự do
Couch: Đi văng
Near: Ở gần
Correct: Chính xác
Statistics: Số liệu thống kê
Neat: Khéo léo
Sentiment: Tình cảm
Hostile: Hostile
Economic: Thuộc kinh tế
Urge: Thúc giục
Television: Tivi
Year: Năm
Consist: Bao gồm
Dance: Nhảy
Planner: Lập kế hoạch
Swallow: Nuốt
Yeah: Yeah
Comfortable: Thoải mái
Comprehensive: Toàn diện
Regarding: Về
Engage: Thuê
Power: Quyền lực
Predict: Tiên đoán
Sovereignty: Chủ quyền
Issue: Vấn đề
Locate: Định vị
Administer: Quản lý
Index: Mục lục
Remind: Nhắc lại
Distribute: Phân phát
Teaching: Giảng bài
Spokesman: Người phát ngôn
Need: Nhu cầu
Execution: Chấp hành
Enemy: Kẻ thù
Jail: Nhà giam
North: Bắc
Teach: Dạy
Achievement: Thành tích
Business: Kinh doanh
Color: Màu
Hundred: Hàng trăm
Interpretation: Diễn dịch
Neighborhood: Khu vực lân cận
Educate: Giáo dục
Airport: Sân bay
Briefly: Ngắn gọn
Distant: Xa xôi
Immediately: Ngay
Listener: Người nghe
Instead: Thay thế
Simultaneously: Đồng thời
Relation: Quan hệ
Scratch: Vết trầy
Respond: Trả lời
Researcher: Nghiên cứu viên
Severely: Nghiêm trọng
Huh: Huh
Rich: Giàu có
Solve: Giải quyết
Hug: Ôm
Alongside: Bên cạnh
Dining: Ăn uống
Salad: Rau xà lách
Recruit: Tuyển dụng
Rice: Cơm
Blind: Mù quáng
Agency: Đại lý
Blink: Chớp mắt
Universe: Vũ trụ
Agenda: Chương trình nghị sự
Diamond: Kim cương
Material: Vật chất
Supportive: Hỗ trợ
Screw: Đinh ốc
Purple: Màu tím
Disappointed: Thất vọng
Emerge: Hiện ra
Existing: Hiện tại
Prescription: Đơn thuốc
Nearly: Gần
Import: Nhập khẩu
Colorful: Đầy màu sắc
Occasion: Dịp
Which: Mà
Image: Hình ảnh
President: Chủ tịch
Board: Bảng
Impose: Áp đặt
Incorporate: Kết hợp
Surgery: Phẫu thuật
Difficult: Khó khăn
Example: Thí dụ
Seriously: Nghiêm túc
Troubled: Gặp rắc rối
Boast: Khoe khoan
Alleged: Cáo buộc
Publicly: Công khai
Surprisingly: Thật ngạc nhiên
Qualify: Đủ tiêu chuẩn
Scare: Sợ hãi
Onion: Củ hành
Structural: Cấu trúc
Pleasant: Dễ chịu
Attractive: Hấp dẫn
Requirement: Yêu cầu
Theater: Rạp hát
Working: Đang làm việc
Concerned: Liên quan
Quart: Quart
Baseball: Bóng chày
Developing: Phát triển
Scary: Đáng sợ
Ride: Dap xe
Proud: Tự hào
Frame: Khung
Besides: Ngoài ra
Indigenous: Bản địa
Catch: Bắt lấy
Empire: Đế chế
Slip: Trượt
Invention: Sự phát minh
Possibly: Có thể
Casualty: Tai nạn
Sensitive: Nhạy cảm
Supplier: Nhà cung cấp
Symptom: Triệu chứng
Improve: Cải tiến
Inspire: Truyền cảm hứng
Prove: Chứng minh
Retailer: Nhà bán lẻ
Possible: Khả thi
Together: Cùng với nhau
South: Miền nam
Tonight: Tối nay
Capital: Thủ đô
Resolve: Giải quyết
Abandon: Từ bỏ
Gift: Quà tặng
Panel: Bảng điều khiển
Told: Kể lại
Insurance: Bảo hiểm
Genre: Thể loại
Prospect: Khách hàng tiềm năng
Toll: Số điện thoại
Transform: Biến đổi
Crush: Nghiền nát
Church: Nhà thờ
Innovative: Sáng tạo
Promising: Hứa hẹn
Yell: Hét lên
Wellknown: Nổi tiếng
Smoke: Hút thuốc lá
Nothing: Không có gì
Took: Lấy
Refuse: Từ chối
Something: Cái gì đó
Cell: Tế bào
Engine: Động cơ
Tool: Dụng cụ
Executive: Điều hành
Skilled: Có kỹ năng
Terms: Điều kiện
Receiver: Người nhận
Islamic: Hồi giáo
Condemn: Lên án
Double: Gấp đôi
Trauma: Chấn thương
Surgeon: Bác sĩ phẫu thuật
Payment: Thanh toán
Donor: Nhà tài trợ
Tone: Tấn
Proof: Bằng chứng
Advice: Khuyên bảo
Giant: Khổng lồ
Detail: Chi tiết
Largely: Phần lớn
Before: Trước
Dictionary: Từ điển
Represent: Đại diện
Require: Yêu cầu
Phase: Giai đoạn
Evaluate: Đánh giá
Mainly: Chủ yếu
Terribly: Khủng khiếp
Halfway: Nửa chừng
Carefully: Cẩn thận
Cent: Cent
Opponent: Phản đối
Height: Chiều cao
Terrible: Khủng khiếp
Syllable: Âm tiết
Comment: Bình luận
Accomplishment: Hoàn thành
Hockey: Khúc côn cầu
Snake: Con rắn
Magic: Ma thuật
Equation: Phương trình
Barrel: Thùng
Scale: Tỉ lệ
Christianity: Cơ đốc giáo
Hungry: Đói bụng
Lately: Gần đây
Restriction: Sự hạn chế
Afraid: Sợ
Construct: Xây dựng
Prevent: Ngăn chặn
Along: Dọc theo
Emergency: Trường hợp khẩn cấp
Severe: Nghiêm trọng
Alone: Một mình
Sophisticated: Tinh vi
Artist: Họa sĩ
Funding: Kinh phí
Slow: Chậm
Frequent: Thường xuyên
Remark: Nhận xét
Assistant: Phụ tá
Combination: Sự phối hợp
Never: Không bao giờ
Survive: Tồn tại
Toss: Quăng
Attract: Thu hút
Metropolitan: Đô thị
Supervisor: Người giám sát
Landscape: Phong cảnh
Roughly: Gần
Lesson: Bài học
Skirt: Váy
Virus: Virus
Accountability: Trách nhiệm giải trình
Afford: Đủ khả năng
Slot: Khe
Effect: Hiệu ứng
Such: Như là
Coming: Đang đến
Monkey: Con khỉ
Listen: Nghe
Fraud: Gian lận
Grab: Vồ lấy
Suck: Hút
Decide: Quyết định
Foreigner: Người nước ngoài
Thoroughly: Triệt để
Innovation: Đổi mới
Broadcast: Phát sóng
Piece: Cái
Voter: Cử tri
Resident: Cư dân
Comprise: Bao gồm
Question: Câu hỏi
Riot: Bạo loạn
Nest: Tổ
Means (pl): Nghĩa là (pl)
Golden: Vàng
Tour: Chuyến du lịch
Protect: Bảo vệ
Echo: Echo
Soccer: Bóng đá
Sufficient: Đủ
O'clock: Giờ
Ice: Nước đá
Carbon: Carbon
Physics: Vật lý
Master: Bậc thầy
Divorce: Ly hôn
Settlement: Giải quyết
Permit: Cho phép
Ghost: Ma
Outcome: Kết quả
Ring: Nhẫn
Needle: Cây kim
Anxious: Lo lắng
Afterward: Sau đó
Tooth: Răng
Expertise: Chuyên môn
Homework: Bài tập về nhà
Hostage: Con tin
Lower: Thấp hơn
Economically: Kinh tế
Wellbeing: Hạnh phúc
Denial: Từ chối
Metal: Kim loại
Modern: Hiện đại
Town: Thị trấn
Taxpayer: Người nộp thuế
Trading: Thương mại
Girl: Con gái
Deliver: Giao hàng
Gray: Màu xám
Territory: Lãnh thổ
Household: Hộ gia đình
Awful: Kinh khủng
Fisherman: Ngư dân
Miracle: Phép màu
Campaign: Chiến dịch
Solely: Chỉ
Democracy: Dân chủ
General: Chung
Vocal: Tiếng hát
Mirror: Gương
Drawing: Vẽ
Action: Hoạt động
Panic: Hoảng loạn
Force: Lực lượng
Driver: Người lái xe
Inside: Phía trong
Risk: Rủi ro
Liberty: Tự do
What: Gì
Rise: Tăng lên
Vanish: Biến mất
Knife: Dao
Rack: Giá đỡ
Exist: Hiện hữu
Strict: Nghiêm khắc
Modest: Khiêm tốn
Elevator: Thang máy
Sauce: Nước xốt
News: Tin tức
Race: Cuộc đua
Peace: Hòa bình
Exact: Chính xác
Grew: Lớn lên
Veteran: Cựu chiến binh
Narrow: Hẹp
Constantly: Liên tục
Recently: Gần đây
Theology: Thần học
Eager: Hăng hái
British: Người anh
Cluster: Cụm
Huge: Khổng lồ
Subject: Môn học
Answer: Câu trả lời
Travel: Du lịch
Skill: Kỹ năng
Jazz: Jazz
Kingdom: Vương quốc
Wonderful: Tuyệt vời
Intention: Ý định
Classical: Cổ điển
Thrive: Phát đạt
Overlook: Bỏ qua
Robot: Robot
Account: Tài khoản
Accomplish: Hoàn thành
Platform: Nền tảng
Suburb: Ngoại ô
Meter: Mét
Opposition: Sự đối lập
Cruel: Hung ác
Suit: Bộ đồ
Orange: Trái cam
Cigarette: Thuốc lá
Give: Đưa cho
Forehead: Trán
Bombing: Ném bom
Moreover: Hơn thế nữa
Isolated: Bị cô lập
Glimpse: Nhìn thoáng qua
Sidewalk: Đường đi bộ
Threshold: Ngưỡng
Remain: Vẫn còn
Banking: Ngân hàng
Insist: Năn nỉ
Elementary: Tiểu học
Reception: Tiếp nhận
Edition: Phiên bản
Honey: Mật ong
Valley: Thung lũng
Next: Kế tiếp
Attend: Tham gia
Revenue: Thu nhập
Package: Gói
Illegal: Bất hợp pháp
Scream: Hét lên
Instinct: Bản năng
Rage: Giận dữ
Distinctive: Đặc biệt
Implementation: Thực hiện
Spectrum: Quang phổ
Grin: Nụ cười
Grip: Nắm chặt
Complaint: Lời phàn nàn
Reliable: Đáng tin cậy
Responsible: Chịu trách nhiệm
Warrior: Chiến binh
Railroad: Đường sắt
Abstract: Trừu tượng
Reference: Tài liệu tham khảo
Portfolio: Danh mục đầu tư
Drawer: Ngăn kéo
Plan: Kế hoạch
Desperately: Tuyệt vọng
Play: Chơi
When: Khi nào
Sometimes: Đôi khi
Chinese: Trung quốc
Achieve: Hoàn thành
Sharply: Mạnh
Pillow: Cái gối
Policy: Chính sách
Custody: Quyền nuôi con
Transformation: Chuyển đổi
Ministry: Bộ
Substantially: Đáng kể
Keep: Giữ
Ill: Bệnh
Summer: Mùa hè
Dependent: Phụ thuộc
Defensive: Phòng ngự
Interact: Tương tác
Parental: Cha mẹ
Hunt: Săn bắn
Rain: Mưa
Rail: Đường sắt
Equality: Bình đẳng
Member: Hội viên
Plea: Lời bào chữa
Adoption: Nhận con nuôi
Inherit: Thừa kế
Accusation: Tố cáo
Endless: Bất tận
Helicopter: Máy bay trực thăng
Literature: Văn chương
Advance: Nâng cao
Deadline: Hạn chót
Setting: Cài đặt
Assault: Tấn công
Romance: Lãng mạn
Advise: Khuyên nhủ
Protein: Chất đạm
Plenty: Nhiều
Active: Đang hoạt động
Mixed: Pha trộn
Brave: Can đảm
Convince: Thuyết phục
Gain: Thu được
Below: Phía dưới
Cable: Cáp
Mechanic: Thợ cơ khí
Embrace: Ôm hôn
User: Người dùng
Toxic: Chất độc
Screen: Màn
Engineering: Kỹ thuật
Moderate: Vừa phải
Compete: Cạnh tranh
Victory: Chiến thắng
Chord: Dây nhau
Breakfast: Bữa ăn sáng
Strike: Đình công
Quantity: Số lượng
Management: Sự quản lý
While: Trong khi
Police: Cảnh sát
Exception: Ngoại lệ
Nervous: Lo lắng
Compelling: Thuyết phục
Whip: Roi da
Used: Đã sử dụng
Bought: Đã mua
Welcome: Chào mừng
Limit: Giới hạn
Ran: Chạy
